,title,production_budget,worldwide_gross,profit,profit_ratio,success,release_month,genres,averagerating
1995,#Horror,1500000,0,-1500000,-1.0,False,11,"['Crime', 'Drama', 'Horror']",3.0
1672,10 Cloverfield Lane,5000000,108286422,103286422,20.6572844,True,3,"['Drama', 'Horror', 'Mystery']",7.2
1389,10 Days in a Madhouse,12000000,14616,-11985384,-0.998782,False,11,['Drama'],6.7
737,12 Strong,35000000,71118378,36118378,1.0319536571428571,False,1,"['Action', 'Drama', 'History']",6.6
1076,12 Years a Slave,20000000,181025343,161025343,8.05126715,True,10,"['Biography', 'Drama', 'History']",8.1
1182,127 Hours,18000000,60217171,42217171,2.345398388888889,True,11,"['Adventure', 'Biography', 'Drama']",7.6
1781,13 Sins,4000000,47552,-3952448,-0.988112,False,4,"['Horror', 'Thriller']",6.3
2067,1982,1000000,0,-1000000,-1.0,False,12,['Drama'],7.0
454,2 Guns,61000000,132493015,71493015,1.1720166393442624,False,8,"['Action', 'Comedy', 'Crime']",6.7
616,21 Jump Street,42000000,202812429,160812429,3.8288673571428573,True,3,"['Action', 'Comedy', 'Crime']",7.2
528,22 Jump Street,50000000,331333876,281333876,5.62667752,True,6,"['Action', 'Comedy', 'Crime']",7.0
2044,23 Blast,1000000,549185,-450815,-0.450815,False,10,"['Drama', 'Family', 'Sport']",6.5
1586,3,7200000,295492,-6904508,-0.9589594444444445,False,8,"['Comedy', 'Drama']",6.1
2138,3 Backyards,300000,39475,-260525,-0.8684166666666666,False,1,['Drama'],5.0
906,3 Days to Kill,28000000,38959900,10959900,0.391425,False,2,"['Action', 'Drama', 'Thriller']",6.2
905,30 Minutes or Less,28000000,40966716,12966716,0.463097,False,8,"['Action', 'Comedy', 'Crime']",6.1
256,300: Rise of an Empire,110000000,330780051,220780051,2.0070913727272726,True,3,"['Action', 'Fantasy', 'War']",6.2
1987,31,1500000,922727,-577273,-0.38484866666666667,False,10,"['Horror', 'Thriller']",5.1
803,42,31000000,97470701,66470701,2.1442161612903226,True,4,"['Biography', 'Drama', 'Sport']",7.5
95,47 Ronin,175000000,151716815,-23283185,-0.13304677142857144,False,12,"['Action', 'Adventure', 'Drama']",6.3
1388,5 Days of War,12000000,87793,-11912207,-0.9926839166666667,False,8,"['Action', 'Drama', 'War']",5.6
1494,50 to 1,10000000,1069454,-8930546,-0.8930546,False,3,['Drama'],6.6
1550,50/50,8000000,41334735,33334735,4.166841875,True,9,['Documentary'],7.5
1887,8 Days,2500000,0,-2500000,-1.0,False,6,"['Drama', 'Thriller']",5.0
1880,8: The Mormon Proposition,2500000,100280,-2399720,-0.959888,False,1,['Documentary'],7.0
1706,90 Minutes in Heaven,5000000,4816142,-183858,-0.0367716,False,9,['Drama'],4.8
895,A Bad Moms Christmas,28000000,127710550,99710550,3.5610910714285713,True,11,"['Adventure', 'Comedy']",5.5
1488,A Better Life,10000000,1884251,-8115749,-0.8115749,False,5,['Drama'],6.6
1134,A Dangerous Method,20000000,14807531,-5192469,-0.25962345,False,11,"['Biography', 'Drama', 'Romance']",6.4
1289,A Few Best Men,15000000,17224539,2224539,0.1483026,False,10,"['Comedy', 'Romance']",5.7
2187,A Ghost Story,100000,2769782,2669782,26.69782,True,7,"['Drama', 'Fantasy', 'Romance']",6.8
314,A Good Day to Die Hard,92000000,304249198,212249198,2.3070565,True,2,"['Action', 'Thriller']",5.3
1873,A Haunted House,2500000,59922558,57422558,22.9690232,True,1,"['Comedy', 'Fantasy']",5.1
1764,A Haunted House 2,4000000,21206861,17206861,4.30171525,True,4,"['Comedy', 'Fantasy']",4.7
772,A Hologram for the King,35000000,11846010,-23153990,-0.6615425714285714,False,4,"['Comedy', 'Drama', 'Romance']",6.1
1347,A Little Bit of Heaven,12500000,1100287,-11399713,-0.91197704,False,2,"['Comedy', 'Drama', 'Fantasy']",6.3
1784,A Lonely Place to Die,4000000,442550,-3557450,-0.8893625,False,4,"['Adventure', 'Crime', 'Thriller']",6.3
613,A Monster Calls,43000000,46414530,3414530,0.07940767441860465,False,12,"['Animation', 'Drama', 'Fantasy']",7.5
1132,A Most Violent Year,20000000,8846875,-11153125,-0.55765625,False,12,"['Crime', 'Drama', 'Thriller']",7.0
1265,A Most Wanted Man,15000000,36068890,21068890,1.4045926666666666,False,7,"['Crime', 'Drama', 'Thriller']",6.8
728,A Nightmare on Elm Street,35000000,117729621,82729621,2.363703457142857,True,4,"['Crime', 'Drama', 'Horror']",5.2
1208,A Quiet Place,17000000,334522294,317522294,18.677782,True,4,['Documentary'],6.6
1079,A Simple Favor,20000000,97628717,77628717,3.88143585,True,9,"['Comedy', 'Crime', 'Drama']",6.9
1575,A Street Cat Named Bob,8000000,17382693,9382693,1.172836625,False,11,"['Biography', 'Comedy', 'Drama']",7.4
679,A Thousand Words,40000000,20790486,-19209514,-0.48023785,False,3,"['Comedy', 'Drama']",5.9
2211,A True Story,45000,0,-45000,-1.0,False,9,['Comedy'],5.2
908,A Walk Among the Tombstones,28000000,62108587,34108587,1.2181638214285715,False,9,"['Action', 'Crime', 'Drama']",6.5
1551,A Walk in the Woods,8000000,37119358,29119358,3.63991975,True,9,"['Adventure', 'Biography', 'Comedy']",6.3
271,A Wrinkle in Time,103000000,133401882,30401882,0.29516390291262135,False,3,"['Adventure', 'Family', 'Fantasy']",4.2
1860,AWOL-72,3000000,0,-3000000,-1.0,False,8,"['Action', 'Thriller']",3.8
750,Abduction,35000000,86648359,51648359,1.4756674,False,9,"['Horror', 'Thriller']",5.2
1321,About Last Night,13000000,50445860,37445860,2.880450769230769,True,2,"['Comedy', 'Romance']",6.1
1370,About Time,12000000,89309178,77309178,6.4424315,True,11,"['Comedy', 'Drama', 'Fantasy']",7.8
2002,Above and Beyond,1300000,288751,-1011249,-0.7778838461538462,False,1,"['Adventure', 'Documentary', 'History']",7.7
425,Abraham Lincoln: Vampire Hunter,67500000,137489730,69989730,1.0368848888888889,False,6,"['Action', 'Fantasy', 'Horror']",5.9
2199,Absentia,70000,8555,-61445,-0.8777857142857143,False,3,"['Drama', 'Horror', 'Mystery']",5.8
933,Accidental Love,26000000,135436,-25864564,-0.9947909230769231,False,2,"['Comedy', 'Romance']",4.1
1084,Acrimony,20000000,46627836,26627836,1.3313918,False,3,"['Drama', 'Romance', 'Thriller']",5.7
1350,Act of Valor,12000000,82497035,70497035,5.874752916666667,True,2,"['Action', 'Adventure', 'Drama']",6.5
1592,Action Jackson,7000000,20257000,13257000,1.893857142857143,False,2,"['Action', 'Thriller']",3.3
1165,Action Point,19000000,5103675,-13896325,-0.7313855263157895,False,6,['Comedy'],5.0
1697,Addicted,5000000,17499242,12499242,2.4998484,True,10,"['Drama', 'Thriller']",5.2
1144,Admiral,20000000,38585047,18585047,0.92925235,False,3,"['Action', 'Adventure', 'Biography']",7.0
1326,Admission,13000000,18733666,5733666,0.44105123076923075,False,3,"['Comedy', 'Drama', 'Romance']",5.7
748,Adrift,35000000,57897191,22897191,0.6542054571428572,False,6,['Drama'],6.0
2089,Adulterers,750000,0,-750000,-1.0,False,1,"['Crime', 'Drama', 'Thriller']",5.2
2094,After,650000,0,-650000,-1.0,False,8,['Romance'],6.3
212,After Earth,130000000,251499665,121499665,0.9346128076923077,False,5,"['Action', 'Adventure', 'Drama']",4.8
1721,Ain't Them Bodies Saints,5000000,1075009,-3924991,-0.7849982,False,8,"['Crime', 'Drama', 'Romance']",6.4
447,Air Strike,65000000,516279,-64483721,-0.9920572461538462,False,10,"['Action', 'Adventure', 'Drama']",3.3
2014,Airborne,1200000,0,-1200000,-1.0,False,2,"['Comedy', 'Crime', 'Horror']",3.9
1581,Albert Nobbs,7500000,8539003,1039003,0.13853373333333333,False,12,"['Drama', 'Romance']",6.7
751,Alex Cross,35000000,35426759,426759,0.012193114285714285,False,10,"['Action', 'Crime', 'Mystery']",5.1
899,"Alexander and the Terrible, Horrible, No Good, Very Bad Day",28000000,101379287,73379287,2.6206888214285713,True,10,"['Comedy', 'Family']",6.2
103,Alice Through the Looking Glass,170000000,276928112,106928112,0.628988894117647,False,5,"['Adventure', 'Family', 'Fantasy']",6.2
44,Alice in Wonderland,200000000,1025491110,825491110,4.12745555,True,1,"['Fantasy', 'Musical']",6.5
297,Alien: Covenant,97000000,238521247,141521247,1.4589819278350515,False,5,"['Horror', 'Sci-Fi', 'Thriller']",6.4
599,All Eyez on Me,45000000,54876855,9876855,0.21948566666666666,False,6,"['Biography', 'Drama', 'Music']",5.8
1140,All Good Things,20000000,873617,-19126383,-0.95631915,False,12,"['Crime', 'Drama', 'Mystery']",6.3
1912,All Saints,2000000,5941994,3941994,1.970997,False,8,['Drama'],6.0
2224,All Superheroes Must Die,20000,0,-20000,-1.0,False,1,"['Sci-Fi', 'Thriller']",4.0
2127,Alleluia! The Devil's Carnival,500000,0,-500000,-1.0,False,3,"['Horror', 'Musical']",6.9
267,Allied,106000000,119266661,13266661,0.12515717924528302,False,11,"['Action', 'Drama', 'Romance']",7.1
1213,Almost Christmas,17000000,42493506,25493506,1.499618,False,11,"['Comedy', 'Drama']",6.1
479,Almost Famous,60000000,47371191,-12628809,-0.21048015,False,9,"['Comedy', 'Drama', 'Family']",4.1
1577,Aloft,8000000,237688,-7762312,-0.970289,False,5,['Drama'],5.3
714,Aloha,37000000,25387091,-11612909,-0.3138624054054054,False,5,"['Comedy', 'Drama', 'Romance']",5.4
524,Alpha,51000000,99624873,48624873,0.9534288823529412,False,1,"['Drama', 'Horror', 'Mystery']",7.7
356,Alvin and the Chipmunks: Chipwrecked,80000000,349088523,269088523,3.3636065375,True,12,"['Adventure', 'Animation', 'Comedy']",4.4
322,Alvin and the Chipmunks: The Road Chip,90000000,249517956,159517956,1.7724217333333334,False,12,"['Adventure', 'Animation', 'Comedy']",5.1
449,American Assassin,63000000,68310140,5310140,0.0842879365079365,False,9,"['Action', 'Thriller']",6.2
1507,American Heist,10000000,2341218,-7658782,-0.7658782,False,7,"['Action', 'Crime', 'Drama']",5.1
2058,American Hero,1000000,26,-999974,-0.999974,False,12,"['Action', 'Comedy', 'Drama']",4.9
1804,American Honey,3500000,2611750,-888250,-0.2537857142857143,False,9,"['Adventure', 'Drama', 'Romance']",7.0
632,American Hustle,40000000,257878294,217878294,5.44695735,True,12,"['Crime', 'Drama']",7.2
546,American Made,50000000,135569212,85569212,1.71138424,False,9,"['Action', 'Biography', 'Comedy']",7.2
544,American Reunion,50000000,236799211,186799211,3.73598422,True,4,['Comedy'],6.7
488,American Sniper,58000000,547326372,489326372,8.436661586206897,True,12,"['Action', 'Biography', 'Drama']",7.3
911,American Ultra,28000000,30295028,2295028,0.08196528571428571,False,8,"['Action', 'Comedy', 'Sci-Fi']",6.1
1989,Amigo,1500000,184705,-1315295,-0.8768633333333333,False,8,"['Drama', 'War']",5.9
1864,Amnesiac,3000000,0,-3000000,-1.0,False,8,"['Drama', 'Horror', 'Thriller']",2.3
1517,Amour,9700000,36787044,27087044,2.792478762886598,True,12,"['Drama', 'Romance']",7.9
530,Anchorman 2: The Legend Continues,50000000,172185754,122185754,2.44371508,True,12,['Comedy'],6.3
1185,And So It Goes,18000000,17920013,-79987,-0.004443722222222222,False,7,"['Comedy', 'Drama', 'Romance']",5.8
2144,Anderson's Cross,300000,0,-300000,-1.0,False,5,"['Comedy', 'Drama', 'Romance']",5.5
1756,Animal Kingdom,4200000,8078683,3878683,0.9234959523809524,False,8,"['Crime', 'Drama']",7.3
1661,Animals,5500000,0,-5500000,-1.0,False,10,['Drama'],8.2
1753,Anna,4357373,1200000,-3157373,-0.7246047102233387,False,10,['Biography'],5.0
576,Anna Karenina,49000000,71004627,22004627,0.44907402040816324,False,11,"['Drama', 'Romance']",6.6
1612,Annabelle,6500000,256862920,250362920,38.517372307692305,True,10,"['Horror', 'Mystery', 'Thriller']",5.4
1237,Annabelle: Creation,15000000,305384865,290384865,19.358991,True,8,"['Horror', 'Mystery', 'Thriller']",6.5
433,Annie,65000000,139829625,74829625,1.151225,False,12,"['Comedy', 'Drama', 'Family']",5.3
513,Annihilation,55000000,43070915,-11929085,-0.21689245454545455,False,2,"['Adventure', 'Drama', 'Horror']",6.9
1563,Anomalisa,8000000,5706168,-2293832,-0.286729,False,12,"['Animation', 'Comedy', 'Drama']",7.3
914,Anonymous,27500000,15815509,-11684491,-0.42489058181818185,False,10,"['Drama', 'Thriller']",6.9
2176,Another Earth,175000,2102779,1927779,11.01588,True,7,"['Drama', 'Romance', 'Sci-Fi']",7.0
1782,Another Happy Day,4000000,978527,-3021473,-0.75536825,False,11,"['Comedy', 'Drama']",6.0
1565,Another Year,8000000,20005613,12005613,1.500701625,False,12,['Documentary'],7.2
180,Ant-Man,130000000,518858449,388858449,2.9912188384615384,True,7,"['Action', 'Adventure', 'Comedy']",7.3
179,Ant-Man and the Wasp,130000000,623144660,493144660,3.7934204615384615,True,7,"['Action', 'Adventure', 'Comedy']",7.1
2047,Antarctica: A Year on Ice,1000000,288757,-711243,-0.711243,False,9,"['Adventure', 'Biography', 'Documentary']",7.6
1888,Antibirth,2500000,0,-2500000,-1.0,False,9,['Horror'],4.9
1820,Antiviral,3100000,123407,-2976593,-0.9601912903225807,False,4,"['Horror', 'Sci-Fi', 'Thriller']",5.7
1695,Apollo 18,5000000,26517819,21517819,4.3035638,True,9,"['Horror', 'Mystery', 'Sci-Fi']",5.2
119,Aquaman,160000000,1146894640,986894640,6.1680915,True,12,"['Action', 'Adventure', 'Fantasy']",7.1
1375,Arbitrage,12000000,35830713,23830713,1.98589275,False,9,"['Drama', 'Thriller']",6.6
1729,Area 51,5000000,7556,-4992444,-0.9984888,False,5,"['Horror', 'Sci-Fi', 'Thriller']",4.2
609,Argo,44500000,227140757,182640757,4.104286674157303,True,10,"['Biography', 'Drama', 'Thriller']",7.7
2183,Aroused,150000,0,-150000,-1.0,False,2,['Documentary'],5.3
581,Arrival,47000000,203127894,156127894,3.321870085106383,True,11,"['Drama', 'Mystery', 'Sci-Fi']",7.9
666,Arthur,40000000,47787943,7787943,0.194698575,False,4,"['Comedy', 'Romance']",5.7
343,Arthur Christmas,85000000,149717124,64717124,0.7613779294117647,False,11,"['Adventure', 'Animation', 'Comedy']",7.1
1692,"As Above, So Below",5000000,41824066,36824066,7.3648132,True,8,"['Adventure', 'Horror', 'Mystery']",6.2
2129,As It Is in Heaven,450000,13486,-436514,-0.9700311111111111,False,8,['Drama'],7.3
2070,Ask Me Anything,950000,0,-950000,-1.0,False,4,['Drama'],6.1
556,Assassins,50000000,83306268,33306268,0.66612536,False,10,"['Action', 'Drama', 'Thriller']",4.4
824,Atomic Blonde,30000000,98345423,68345423,2.2781807666666665,True,7,"['Action', 'Mystery', 'Thriller']",6.7
1338,Attack the Block,13000000,6459183,-6540817,-0.5031397692307692,False,7,"['Action', 'Comedy', 'Sci-Fi']",6.7
1811,August,3400000,12636,-3387364,-0.9962835294117647,False,6,['Drama'],4.2
952,August: Osage County,25000000,50738810,25738810,1.0295524,False,12,"['Comedy', 'Drama']",7.2
0,Avatar,425000000,2776345279,2351345279,5.532577127058824,True,12,['Horror'],6.1
2,Avengers: Age of Ultron,330600000,1403013963,1072413963,3.2438413883847548,True,5,"['Action', 'Adventure', 'Sci-Fi']",7.3
3,Avengers: Infinity War,300000000,2048134200,1748134200,5.827114,True,4,"['Action', 'Adventure', 'Sci-Fi']",8.5
861,Baahubali 2: The Conclusion,30000000,263502914,233502914,7.783430466666666,True,4,"['Action', 'Drama']",8.3
779,Baby Driver,34000000,228104185,194104185,5.708946617647059,True,6,"['Action', 'Crime', 'Drama']",7.6
1848,Bachelorette,3000000,12577401,9577401,3.192467,True,9,"['Comedy', 'Romance']",5.3
409,Bad Company,70000000,69157016,-842984,-0.01204262857142857,False,8,['Thriller'],5.1
1071,Bad Moms,20000000,180998716,160998716,8.0499358,True,7,['Comedy'],6.2
1155,Bad Teacher,19000000,215448997,196448997,10.339420894736842,True,6,"['Comedy', 'Romance']",5.7
799,Bad Times at the El Royale,32000000,29204379,-2795621,-0.08736315625,False,10,"['Crime', 'Drama', 'Mystery']",7.1
1463,Bad Words,10000000,7843145,-2156855,-0.2156855,False,3,"['Comedy', 'Drama']",6.7
1545,Baggage Claim,8500000,22885836,14385836,1.692451294117647,False,9,['Comedy'],5.1
763,Bait,35000000,15471969,-19528031,-0.5579437428571429,False,9,['Drama'],7.0
1332,Bajrangi Bhaijaan,13000000,121778347,108778347,8.367565153846154,True,7,"['Action', 'Comedy', 'Drama']",8.0
856,Ballerina,30000000,96892829,66892829,2.2297609666666665,True,8,"['Biography', 'Documentary']",7.5
2069,Banshee Chapter,950000,78122,-871878,-0.9177663157894737,False,11,"['Horror', 'Sci-Fi', 'Thriller']",5.5
1505,Barbecue,10000000,247565,-9752435,-0.9752435,False,3,['Documentary'],6.5
1078,Barbershop: The Next Cut,20000000,54404202,34404202,1.7202101,False,4,"['Comedy', 'Drama']",5.9
870,Barney's Version,30000000,8845575,-21154425,-0.7051475,False,1,"['Comedy', 'Drama']",7.3
1859,Barry Munday,3000000,0,-3000000,-1.0,False,3,"['Comedy', 'Drama', 'Romance']",5.9
14,Batman v Superman: Dawn of Justice,250000000,867500281,617500281,2.470001124,True,3,"['Action', 'Adventure', 'Fantasy']",6.5
988,Battle of the Sexes,25000000,18445379,-6554621,-0.26218484,False,12,"['Biography', 'Comedy', 'Drama']",6.7
1126,Battle of the Year,20000000,16723377,-3276623,-0.16383115,False,9,"['Drama', 'Music']",5.1
24,Battleship,220000000,313477717,93477717,0.4248987136363636,False,5,"['Action', 'Adventure', 'Sci-Fi']",5.8
464,Baywatch,60000000,175863783,115863783,1.93106305,False,5,"['Action', 'Comedy', 'Crime']",5.6
1214,Beastly,17000000,38028230,21028230,1.236954705882353,False,3,"['Drama', 'Fantasy', 'Romance']",5.6
1965,Beasts of the Southern Wild,1800000,23265132,21465132,11.925073333333334,True,6,"['Adventure', 'Drama', 'Fantasy']",7.3
1534,Beautiful,9000000,3134509,-5865491,-0.6517212222222222,False,12,"['Biography', 'Drama', 'Family']",7.5
997,Beautiful Boy,25000000,13031424,-11968576,-0.47874304,False,10,['Drama'],6.6
566,Beautiful Creatures,50000000,60282876,10282876,0.20565752,False,2,"['Drama', 'Fantasy', 'Romance']",6.2
113,Beauty and the Beast,160000000,1259199706,1099199706,6.8699981625,True,1,"['Drama', 'Fantasy', 'Romance']",6.4
1700,Before I Fall,5000000,18945682,13945682,2.7891364,True,3,"['Drama', 'Fantasy', 'Mystery']",6.4
1051,Before I Go to Sleep,22000000,19563579,-2436421,-0.11074640909090909,False,10,"['Drama', 'Horror', 'Mystery']",6.3
1829,Before Midnight,3000000,23251930,20251930,6.7506433333333336,True,6,"['Drama', 'Romance']",7.9
1853,Before We Go,3000000,483938,-2516062,-0.8386873333333333,False,5,"['Documentary', 'Drama', 'News']",7.0
1557,Begin Again,8000000,68838736,60838736,7.604842,True,7,"['Drama', 'Family']",7.0
1817,Beginners,3200000,14314407,11114407,3.4732521875,True,6,"['Comedy', 'Drama', 'Romance']",7.2
1803,Believe,3500000,890303,-2609697,-0.7456277142857143,False,12,['Drama'],5.0
520,Beloved,53000000,22852487,-30147513,-0.568821,False,8,['Drama'],6.7
2012,Below Zero,1200000,0,-1200000,-1.0,False,10,['Thriller'],4.4
308,Ben-Hur,95000000,91669648,-3330352,-0.03505633684210526,False,8,"['Action', 'Adventure', 'Drama']",5.7
2207,Bending Steel,50000,0,-50000,-1.0,False,4,['Documentary'],7.9
1539,Beneath Hill 60,9000000,3440939,-5559061,-0.6176734444444445,False,6,"['Drama', 'History', 'War']",7.1
2103,Benji,500000,31559560,31059560,62.11912,True,10,"['Documentary', 'Sport']",7.4
1627,Bernie,6000000,10106975,4106975,0.6844958333333333,False,4,"['Biography', 'Comedy', 'Crime']",6.8
2017,Beyond the Black Rainbow,1100000,56491,-1043509,-0.9486445454545455,False,9,"['Horror', 'Sci-Fi', 'Thriller']",6.0
1596,Beyond the Lights,7000000,14618727,7618727,1.0883895714285714,False,11,"['Drama', 'Music', 'Romance']",6.9
1169,Big,18000000,151668774,133668774,7.426043,True,6,['Documentary'],8.5
1449,Big Eyes,10000000,27317872,17317872,1.7317872,False,12,['Documentary'],7.2
107,Big Hero 6,165000000,652127828,487127828,2.952289866666667,True,11,"['Action', 'Adventure', 'Animation']",7.8
677,Big Miracle,40000000,25268680,-14731320,-0.368283,False,2,"['Biography', 'Drama', 'Family']",6.5
797,"Big Mommas: Like Father, Like Son",32000000,82332450,50332450,1.5728890625,False,2,"['Action', 'Comedy', 'Crime']",4.4
878,Bilal: A New Breed of Hero,30000000,648599,-29351401,-0.9783800333333333,False,2,"['Action', 'Adventure', 'Animation']",8.0
1150,Bird Box,19800000,0,-19800000,-1.0,False,11,"['Drama', 'Horror', 'Sci-Fi']",6.6
810,Birth of the Dragon,31000000,7220490,-23779510,-0.7670809677419355,False,8,"['Action', 'Biography', 'Drama']",5.4
1063,Bitter Harvest,21000000,606162,-20393838,-0.9711351428571429,False,2,"['Drama', 'Romance', 'War']",6.1
771,Biutiful,35000000,24687524,-10312476,-0.2946421714285714,False,12,"['Drama', 'Romance']",7.5
1246,BlacKkKlansman,15000000,93017335,78017335,5.201155666666667,True,7,"['Biography', 'Crime', 'Drama']",7.5
519,Black Mass,53000000,98837872,45837872,0.8648655094339622,False,5,"['Biography', 'Crime', 'Drama']",6.9
1206,Black Nativity,17500000,7285135,-10214865,-0.5837065714285714,False,11,"['Drama', 'Family', 'Music']",4.6
1583,Black November,7500000,32572,-7467428,-0.9956570666666666,False,12,"['Action', 'Crime', 'Drama']",5.4
35,Black Panther,200000000,1348258224,1148258224,5.74129112,True,1,"['Action', 'Adventure', 'Sci-Fi']",7.3
2060,Black Rock,1000000,0,-1000000,-1.0,False,1,"['Horror', 'Thriller']",4.8
1316,Black Swan,13000000,331266710,318266710,24.482054615384616,True,12,"['Drama', 'Thriller']",8.0
1527,Black or White,9000000,21971021,12971021,1.4412245555555556,False,1,['Drama'],6.6
414,Blackhat,70000000,19665004,-50334996,-0.7190713714285715,False,1,"['Action', 'Crime', 'Thriller']",5.4
1747,Blackthorn,4500000,1217307,-3282693,-0.7294873333333334,False,10,"['Action', 'Adventure', 'Western']",6.6
71,Blade Runner 2049,185000000,259357408,74357408,0.40193193513513514,False,10,"['Drama', 'Mystery', 'Sci-Fi']",8.0
1440,Blair Witch,10000000,38985577,28985577,2.8985577,True,9,"['Horror', 'Mystery', 'Thriller']",5.0
1228,Bleed for This,16000000,6603926,-9396074,-0.587254625,False,11,"['Biography', 'Drama', 'Sport']",6.8
2015,Bleeding Hearts,1200000,0,-1200000,-1.0,False,6,['Horror'],3.4
598,Blended,45000000,127990741,82990741,1.8442386888888889,False,5,"['Comedy', 'Romance']",6.5
1056,Blockers,21000000,94045328,73045328,3.4783489523809523,True,4,['Comedy'],6.2
1501,Blood Done Sign My Name,10000000,109383,-9890617,-0.9890617,False,2,['Drama'],6.6
2011,Blood Feast,1200000,8708,-1191292,-0.9927433333333333,False,6,['Horror'],4.9
932,Blood Ties,26000000,2923959,-23076041,-0.8875400384615385,False,3,"['Documentary', 'Drama', 'Family']",7.0
1176,Blue Jasmine,18000000,102912961,84912961,4.717386722222222,True,7,['Drama'],7.3
2009,Blue Like Jazz,1200000,595018,-604982,-0.5041516666666667,False,4,"['Comedy', 'Drama']",5.9
2130,Blue Ruin,420000,437002,17002,0.04048095238095238,False,4,"['Crime', 'Drama', 'Thriller']",7.1
2026,Blue Valentine,1000000,16566240,15566240,15.56624,True,12,"['Drama', 'Romance']",7.4
1301,Bobby,14000000,20597806,6597806,0.47127185714285713,False,5,['Drama'],8.9
498,Bohemian Rhapsody,55000000,894985342,839985342,15.272460763636364,True,11,"['Biography', 'Drama', 'Music']",8.0
1939,Bone Tomahawk,2000000,475846,-1524154,-0.762077,False,10,"['Adventure', 'Drama', 'Horror']",7.1
1466,Bones,10000000,8378853,-1621147,-0.1621147,False,3,['Drama'],6.6
1412,Book Club,10000000,91113683,81113683,8.1113683,True,5,['Documentary'],6.6
2113,Born to Fly: Elizabeth Streb vs. Gravity,500000,1822,-498178,-0.996356,False,3,"['Action', 'Biography', 'Documentary']",6.7
1746,Bound,4500000,7011317,2511317,0.5580704444444444,False,1,"['Drama', 'Thriller']",3.5
1762,Boyhood,4000000,57273049,53273049,13.31826225,True,7,['Drama'],7.9
1974,Braid,1660000,80745,-1579255,-0.9513584337349398,False,2,"['Horror', 'Mystery', 'Thriller']",5.3
67,Brave,185000000,554606532,369606532,1.997873145945946,False,1,"['Adventure', 'Animation', 'Comedy']",7.1
1621,Breaking In,6000000,51411620,45411620,7.568603333333333,True,1,"['Action', 'Crime', 'Drama']",5.4
1593,Breathless,7000000,19910002,12910002,1.844286,False,1,['Documentary'],7.4
910,Brick Mansions,28000000,73421224,45421224,1.6221865714285715,False,4,"['Action', 'Crime']",5.7
791,Bridesmaids,32500000,289632023,257132023,7.911754553846154,True,5,"['Comedy', 'Romance']",6.8
646,Bridge of Spies,40000000,162498338,122498338,3.06245845,True,10,"['Drama', 'History', 'Thriller']",7.6
336,Bright,90000000,0,-90000000,-1.0,False,12,"['Action', 'Crime', 'Fantasy']",6.4
1406,Brighton Rock,11000000,229653,-10770347,-0.9791224545454545,False,8,"['Crime', 'Drama', 'Thriller']",5.7
759,Broken City,35000000,34480045,-519955,-0.014855857142857143,False,1,"['Crime', 'Drama', 'Thriller']",6.2
1292,Broken Horses,15000000,3471,-14996529,-0.9997686,False,4,"['Action', 'Crime', 'Drama']",5.7
1397,Brooklyn,11000000,62076141,51076141,4.643285545454545,True,11,"['Drama', 'Music', 'Musical']",6.4
1385,Brother,12000000,450594,-11549406,-0.9624505,False,6,"['Comedy', 'Drama', 'Thriller']",5.9
1957,Brotherly Love,1900000,478595,-1421405,-0.7481078947368421,False,4,['Drama'],5.8
924,Brothers,26000000,45043870,19043870,0.7324565384615385,False,1,['Action'],5.1
1483,Bucky Larson: Born to Be a Star,10000000,2529395,-7470605,-0.7470605,False,9,['Comedy'],3.3
517,Bullet to the Head,55000000,22597969,-32402031,-0.5891278363636364,False,2,"['Action', 'Crime', 'Thriller']",5.7
1900,Bully,2100000,1381824,-718176,-0.3419885714285714,False,4,"['Drama', 'Musical']",7.9
272,Bumblebee,102000000,465195589,363195589,3.560741068627451,True,12,"['Action', 'Adventure', 'Sci-Fi']",6.9
1956,Buried,1987650,21270290,19282640,9.701225064774986,True,9,['Thriller'],6.0
510,Burlesque,55000000,90552675,35552675,0.6464122727272728,False,11,['Drama'],7.0
2165,Burn,225000,1109276,884276,3.9301155555555556,True,1,['Documentary'],7.5
1116,Burnt,20000000,36773510,16773510,0.8386755,False,10,"['Comedy', 'Drama']",6.6
2161,Butterfly,250000,0,-250000,-1.0,False,10,"['Documentary', 'Sport']",7.8
2175,Butterfly Girl,180000,17503,-162497,-0.9027611111111111,False,3,['Documentary'],8.6
1141,By the Sea,20000000,3727746,-16272254,-0.8136127,False,11,['Drama'],8.0
1309,Ca$h,13700000,11738256,-1961744,-0.14319299270072994,False,1,"['Crime', 'Thriller']",6.0
1981,Cabin Fever,1500000,30351664,28851664,19.234442666666666,True,2,['Horror'],3.7
2054,Camp X-Ray,1000000,101053,-898947,-0.898947,False,10,"['Drama', 'War']",6.9
1461,Can You Ever Forgive Me?,10000000,11752387,1752387,0.1752387,False,10,"['Biography', 'Comedy', 'Crime']",7.2
13,Captain America: Civil War,250000000,1140069413,890069413,3.560277652,True,5,"['Action', 'Adventure', 'Sci-Fi']",7.8
162,Captain America: The First Avenger,140000000,370569776,230569776,1.6469269714285715,False,7,"['Action', 'Adventure', 'Sci-Fi']",6.9
99,Captain America: The Winter Soldier,170000000,714401889,544401889,3.2023640529411765,True,4,"['Action', 'Adventure', 'Sci-Fi']",7.8
500,Captain Phillips,55000000,220648184,165648184,3.0117851636363637,True,10,"['Biography', 'Drama', 'Thriller']",7.8
691,Captain Underpants: The First Epic Movie,38000000,126577874,88577874,2.3309966842105263,True,6,"['Action', 'Animation', 'Comedy']",6.2
1917,Captive,2000000,2791973,791973,0.3959865,False,4,"['Action', 'Thriller']",3.8
1757,Cargo,4200000,313230,-3886770,-0.9254214285714286,False,10,['Drama'],7.9
999,Carnage,25000000,38112154,13112154,0.52448616,False,12,['Comedy'],7.8
1392,Carol,11800000,42843521,31043521,2.6308068644067797,True,11,"['Drama', 'Romance']",7.2
841,Carrie,30000000,82409520,52409520,1.746984,False,10,"['Drama', 'Horror']",5.9
52,Cars 2,200000000,560155383,360155383,1.800776915,False,6,"['Adventure', 'Animation', 'Comedy']",6.2
93,Cars 3,175000000,383541369,208541369,1.1916649657142857,False,6,"['Adventure', 'Animation', 'Comedy']",6.8
1345,Casino Jack,12500000,2272186,-10227814,-0.81822512,False,12,"['Biography', 'Comedy', 'Crime']",6.2
345,Cats & Dogs: The Revenge of Kitty Galore,85000000,113026383,28026383,0.32972215294117646,False,7,"['Action', 'Comedy', 'Family']",4.3
1469,Cedar Rapids,10000000,7862131,-2137869,-0.2137869,False,2,['Comedy'],6.3
529,Central Intelligence,50000000,217194805,167194805,3.3438961,True,6,"['Action', 'Comedy', 'Crime']",6.3
1285,Centurion,15000000,7885048,-7114952,-0.47433013333333335,False,2,"['Action', 'Adventure', 'Drama']",6.4
1788,Chain of Command,4000000,0,-4000000,-1.0,False,9,"['Action', 'Thriller']",3.5
575,Chappie,49000000,105002056,56002056,1.1428991020408164,False,3,"['Action', 'Crime', 'Drama']",6.8
610,Charlie St. Cloud,44000000,48478084,4478084,0.10177463636363636,False,5,"['Drama', 'Fantasy', 'Romance']",6.5
1131,Chasing Mavericks,20000000,8300821,-11699179,-0.58495895,False,10,"['Biography', 'Drama', 'Sport']",7.2
2188,Cheap Thrills,100000,59424,-40576,-0.40576,False,3,"['Comedy', 'Crime', 'Drama']",6.7
1997,Checkmate,1500000,0,-1500000,-1.0,False,1,"['Drama', 'Mystery']",4.7
2068,Chemical Cut,1000000,0,-1000000,-1.0,False,1,['Drama'],5.4
2025,Chernobyl Diaries,1000000,42411721,41411721,41.411721,True,5,"['Horror', 'Mystery', 'Thriller']",5.0
570,Child 44,50000000,8004221,-41995779,-0.83991558,False,4,"['Crime', 'Drama', 'History']",6.5
1333,Chloe,13000000,11831131,-1168869,-0.089913,False,3,"['Drama', 'Music', 'Romance']",6.9
1885,Christmas Mail,2500000,0,-2500000,-1.0,False,12,"['Comedy', 'Drama', 'Family']",5.8
383,Christopher Robin,75000000,197504758,122504758,1.6333967733333334,False,8,"['Adventure', 'Animation', 'Comedy']",7.3
1351,Chronicle,12000000,123681790,111681790,9.306815833333333,True,2,"['Drama', 'Sci-Fi', 'Thriller']",7.1
1493,Churchill,10000000,7582196,-2417804,-0.2417804,False,6,"['Biography', 'Drama', 'History']",6.3
299,Cinderella,95000000,534551353,439551353,4.626856347368421,True,3,"['Drama', 'Family', 'Fantasy']",6.9
1934,Circle,2000000,10024,-1989976,-0.994988,False,5,"['Horror', 'Thriller']",3.4
2077,Circumstance,900000,958978,58978,0.06553111111111111,False,8,['Drama'],5.9
991,Cirque du Soleil: Worlds Away,25000000,28012862,3012862,0.12051448,False,12,['Fantasy'],6.8
1207,City of Ghosts,17500000,325491,-17174509,-0.9814005142857143,False,7,"['Documentary', 'War']",7.4
223,Clash of the Titans,125000000,493214888,368214888,2.945719104,True,4,"['Action', 'Adventure', 'Fantasy']",5.8
1866,Close Range,3000000,0,-3000000,-1.0,False,12,"['Action', 'Crime']",5.0
1993,Closer to the Moon,1500000,5396,-1494604,-0.9964026666666667,False,11,"['Comedy', 'Crime', 'Drama']",7.0
2192,Closure,100000,0,-100000,-1.0,False,1,"['Comedy', 'Drama']",7.9
273,Cloud Atlas,102000000,130673154,28673154,0.28110935294117645,False,10,"['Action', 'Drama', 'Mystery']",7.4
373,Cloudy with a Chance of Meatballs 2,78000000,274392649,196392649,2.517854474358974,True,9,"['Adventure', 'Animation', 'Comedy']",6.4
91,Coco,175000000,798008101,623008101,3.5600462914285713,True,11,['Horror'],7.4
1579,Code of Honor,8000000,0,-8000000,-1.0,False,5,"['Action', 'Crime', 'Thriller']",4.2
1949,Coffee Town,2000000,0,-2000000,-1.0,False,7,['Comedy'],6.6
717,Collateral Beauty,36000000,85309093,49309093,1.3696970277777778,False,12,"['Drama', 'Romance']",6.8
884,Collide,29200000,5466698,-23733302,-0.8127843150684931,False,2,['Action'],5.5
664,Colombiana,40000000,72295262,32295262,0.80738155,False,8,"['Action', 'Drama', 'Thriller']",6.4
2090,Columbus,700000,1110511,410511,0.5864442857142858,False,8,['Comedy'],5.8
1826,Coming Home,3000000,32653000,29653000,9.884333333333334,True,10,['Drama'],6.0
1837,Compadres,3000000,7445044,4445044,1.4816813333333334,False,4,"['Action', 'Comedy', 'Crime']",4.7
2145,Compliance,270000,830700,560700,2.0766666666666667,True,8,"['Biography', 'Crime', 'Drama']",6.4
329,Conan the Barbarian,90000000,63356133,-26643867,-0.2960429666666667,False,8,"['Action', 'Adventure', 'Fantasy']",5.2
744,Concussion,35000000,50363790,15363790,0.43896542857142856,False,12,['Drama'],5.7
364,Conspiracy Theory,80000000,142783718,62783718,0.784796475,False,1,"['Horror', 'Thriller']",5.8
460,Contagion,60000000,137551594,77551594,1.2925265666666668,False,9,"['Action', 'Drama', 'Thriller']",6.6
942,Contraband,25000000,98406855,73406855,2.9362742,True,1,"['Action', 'Crime', 'Drama']",6.5
1344,Conviction,12500000,11826980,-673020,-0.0538416,False,10,['Drama'],7.0
1722,Cop Car,5000000,143658,-4856342,-0.9712684,False,8,"['Crime', 'Thriller']",6.3
712,Cop Out,37000000,55909910,18909910,0.5110786486486486,False,2,"['Action', 'Comedy', 'Crime']",5.6
1095,Copycat,20000000,32051917,12051917,0.60259585,False,3,['Comedy'],5.1
1495,Coriolanus,10000000,2179623,-7820377,-0.7820377,False,1,"['Drama', 'History', 'War']",8.7
2205,Counting,50000,8374,-41626,-0.83252,False,7,['Documentary'],6.0
1264,Country Strong,15000000,20601987,5601987,0.3734658,False,12,"['Drama', 'Music']",6.3
1903,Courageous,2000000,35185884,33185884,16.592942,True,9,['Drama'],7.0
1220,Crawl,17000000,0,-17000000,-1.0,False,10,['Drama'],6.0
811,Crazy Rich Asians,30000000,238099711,208099711,6.936657033333334,True,8,"['Comedy', 'Romance']",7.0
2050,Creative Control,1000000,63014,-936986,-0.936986,False,3,"['Drama', 'Sci-Fi']",5.4
1849,Creature,3000000,331000,-2669000,-0.8896666666666667,False,9,"['Action', 'Horror', 'Sci-Fi']",3.2
707,Creed,37000000,173567581,136567581,3.691015702702703,True,11,['Horror'],6.6
532,Creed II,50000000,213591522,163591522,3.27183044,True,11,"['Drama', 'Sport']",7.2
802,Criminal,31500000,38771262,7271262,0.23083371428571428,False,4,"['Action', 'Crime', 'Drama']",6.3
1608,Criminal Activities,7000000,386744,-6613256,-0.9447508571428571,False,11,"['Crime', 'Drama', 'Thriller']",5.8
514,Crimson Peak,55000000,74966854,19966854,0.3630337090909091,False,10,"['Drama', 'Fantasy', 'Horror']",6.5
1360,Crossroads,12000000,57000000,45000000,3.75,True,10,"['Action', 'Crime', 'Drama']",7.8
2013,Crowsnest,1200000,0,-1200000,-1.0,False,1,"['Horror', 'Mystery', 'Thriller']",3.9
760,Cursed,35000000,25114901,-9885099,-0.2824314,False,4,['Comedy'],8.3
1598,Cyrus,7000000,10062896,3062896,0.4375565714285714,False,6,"['Crime', 'Horror', 'Mystery']",4.7
2007,Da Sweet Blood of Jesus,1250000,0,-1250000,-1.0,False,6,"['Comedy', 'Romance', 'Thriller']",4.1
1684,Dallas Buyers Club,5000000,60611845,55611845,11.122369,True,11,"['Biography', 'Drama']",8.0
1843,Damsels in Distress,3000000,1324299,-1675701,-0.558567,False,4,"['Comedy', 'Drama', 'Romance']",5.7
1518,Dangal,9500000,294654618,285154618,30.01627557894737,True,12,['Action'],4.1
1008,Dangerous Liaisons,24200000,10447579,-13752421,-0.5682818595041322,False,11,"['Drama', 'Mystery', 'Romance']",5.9
1472,Danny Collins,10000000,8465845,-1534155,-0.1534155,False,3,"['Biography', 'Comedy', 'Drama']",7.0
149,Dark Shadows,150000000,238202668,88202668,0.5880177866666667,False,5,"['Comedy', 'Fantasy', 'Horror']",6.2
1798,Dark Skies,3500000,27704111,24204111,6.9154602857142855,True,2,"['Horror', 'Sci-Fi', 'Thriller']",6.3
819,Darkest Hour,30000000,150807172,120807172,4.026905733333333,True,11,"['Biography', 'Drama', 'History']",7.4
1383,Darling Companion,12000000,1200346,-10799654,-0.8999711666666667,False,4,"['Comedy', 'Drama', 'Romance']",5.1
505,Date Night,55000000,152269033,97269033,1.7685278727272726,False,4,"['Comedy', 'Crime', 'Romance']",6.3
1809,Dawn Patrol,3500000,0,-3500000,-1.0,False,6,"['Drama', 'Thriller']",4.8
2196,Dawn of the Crescent Moon,75000,8799,-66201,-0.88268,False,4,"['Drama', 'Sci-Fi', 'Thriller']",5.1
100,Dawn of the Planet of the Apes,170000000,710644566,540644566,3.1802621529411765,True,7,"['Action', 'Adventure', 'Drama']",7.6
367,Daylight,80000000,158908290,78908290,0.986353625,False,7,"['Crime', 'Horror', 'Thriller']",5.1
866,Dead Man Down,30000000,19599974,-10400026,-0.34666753333333333,False,3,"['Action', 'Crime', 'Drama']",6.5
1637,Deadfall,6000000,1673635,-4326365,-0.7210608333333334,False,12,"['Crime', 'Drama', 'Thriller']",6.3
1967,Deadline,1800000,0,-1800000,-1.0,False,2,"['Comedy', 'Romance']",8.5
487,Deadpool,58000000,801025593,743025593,12.810786086206896,True,2,"['Action', 'Adventure', 'Comedy']",8.0
252,Deadpool 2,110000000,786680557,676680557,6.151641427272727,True,5,"['Action', 'Adventure', 'Comedy']",7.8
939,Dear John,25000000,142033509,117033509,4.68134036,True,2,"['Drama', 'Romance', 'War']",6.3
2005,Dear White People,1250000,5403771,4153771,3.3230168,True,10,"['Comedy', 'Drama', 'Romance']",6.1
844,Death Wish,30000000,48575965,18575965,0.6191988333333334,False,3,"['Action', 'Crime', 'Drama']",6.4
1057,Death at a Funeral,21000000,48977233,27977233,1.3322491904761904,False,4,['Comedy'],5.7
2108,Deceptive Practice: The Mysteries and Mentors of Ricky Jay,500000,152449,-347551,-0.695102,False,10,['Documentary'],7.1
128,Deepwater Horizon,156000000,122603824,-33396176,-0.2140780512820513,False,9,"['Action', 'Drama', 'History']",7.1
850,Deliver Us from Evil,30000000,87956618,57956618,1.9318872666666667,False,7,"['Horror', 'Mystery', 'Thriller']",6.2
1040,Delivery Man,22000000,70536870,48536870,2.2062213636363635,True,11,"['Comedy', 'Drama']",6.4
1856,Demonic,3000000,4668109,1668109,0.5560363333333334,False,3,['Documentary'],5.7
827,Den of Thieves,30000000,80131391,50131391,1.6710463666666666,False,1,"['Action', 'Crime', 'Drama']",7.0
1475,Denial,10000000,9263940,-736060,-0.073606,False,9,['Documentary'],7.4
2019,Departure,1100000,27561,-1072439,-0.9749445454545455,False,5,"['Drama', 'Romance']",6.7
1039,Derailed,22000000,57520063,35520063,1.614548318181818,False,11,"['Action', 'Crime']",6.3
1777,Desert Dancer,4000000,596335,-3403665,-0.85091625,False,3,"['Biography', 'Drama', 'Music']",6.2
415,Despicable Me,69000000,543464573,474464573,6.87629815942029,True,7,"['Animation', 'Comedy', 'Family']",7.7
376,Despicable Me 2,76000000,975216835,899216835,11.831800460526315,True,7,"['Adventure', 'Animation', 'Comedy']",7.4
380,Despicable Me 3,75000000,1034727750,959727750,12.79637,True,6,"['Adventure', 'Animation', 'Comedy']",6.3
1537,Destroyer,9000000,3681096,-5318904,-0.5909893333333334,False,12,"['Action', 'Crime', 'Drama']",6.2
1512,Detention,10000000,0,-10000000,-1.0,False,1,"['Horror', 'Thriller']",3.0
2114,Detention of the Dead,500000,1778,-498222,-0.996444,False,4,"['Action', 'Adventure', 'Comedy']",4.6
1424,Devil,10000000,63354114,53354114,5.3354114,True,9,"['Horror', 'Mystery', 'Thriller']",6.2
1595,Devil's Due,7000000,36146087,29146087,4.163726714285715,True,1,"['Horror', 'Mystery', 'Thriller']",4.1
1019,Dhoom 3,24000000,11723620,-12276380,-0.5115158333333333,False,12,"['Action', 'Thriller']",5.4
2124,Diamond Ruff,500000,0,-500000,-1.0,False,1,['Action'],4.3
1870,Diane,2660000,0,-2660000,-1.0,False,4,"['Crime', 'Drama', 'Horror']",4.6
1240,Diary of a Wimpy Kid,15000000,76954311,61954311,4.1302874,True,3,"['Comedy', 'Drama', 'Family']",6.2
1038,Diary of a Wimpy Kid: Dog Days,22000000,77229695,55229695,2.510440681818182,True,8,"['Comedy', 'Family']",6.3
1173,Diary of a Wimpy Kid: Rodrick Rules,18000000,73695194,55695194,3.0941774444444445,True,3,"['Comedy', 'Family']",6.6
1042,Diary of a Wimpy Kid: The Long Haul,22000000,35609577,13609577,0.6186171363636364,False,5,"['Comedy', 'Family']",4.4
416,Dinner for Schmucks,69000000,86796502,17796502,0.2579203188405797,False,7,['Comedy'],5.9
1394,Dirty Grandpa,11500000,105078449,93578449,8.137256434782609,True,1,['Comedy'],5.9
338,Divergent,85000000,276014965,191014965,2.247234882352941,True,3,"['Action', 'Adventure', 'Mystery']",6.7
274,Django Unchained,100000000,449948323,349948323,3.49948323,True,12,"['Drama', 'Western']",8.4
1890,Do You Believe?,2300000,14304931,12004931,5.2195352173913045,True,3,"['Fantasy', 'Horror']",3.8
2063,Doc Holliday's Revenge,1000000,0,-1000000,-1.0,False,6,['Western'],3.8
105,Doctor Strange,165000000,676404566,511404566,3.099421612121212,True,11,"['Action', 'Adventure', 'Fantasy']",7.5
710,Dolphin Tale,37000000,96068724,59068724,1.596452,False,9,"['Drama', 'Family']",6.9
716,Dolphin Tale 2,36000000,57824533,21824533,0.6062370277777778,False,9,"['Drama', 'Family']",6.4
1604,Dom Hemingway,7000000,1857458,-5142542,-0.7346488571428571,False,4,"['Comedy', 'Crime', 'Drama']",6.2
1652,Don Jon,5500000,41268579,35768579,6.503378,True,9,"['Comedy', 'Drama', 'Romance']",6.6
962,Don't Be Afraid of the Dark,25000000,39126427,14126427,0.56505708,False,11,"['Fantasy', 'Horror', 'Thriller']",5.6
1594,Dope,7000000,18190831,11190831,1.598690142857143,False,6,"['Comedy', 'Crime', 'Drama']",7.2
2206,Down and Dangerous,50000,0,-50000,-1.0,False,2,"['Crime', 'Thriller']",5.2
423,Downsizing,68000000,54462971,-13537029,-0.19907395588235294,False,12,"['Drama', 'Sci-Fi']",5.7
404,Dracula Untold,70000000,220241723,150241723,2.1463103285714284,True,10,"['Action', 'Drama', 'Fantasy']",6.3
960,Draft Day,25000000,29847480,4847480,0.1938992,False,4,"['Drama', 'Sport']",6.8
1544,Dragon Ball Super: Broly,8500000,122747755,114247755,13.440912352941176,True,1,"['Action', 'Adventure', 'Animation']",8.0
481,Dragonfly,60000000,30063805,-29936195,-0.49893658333333335,False,4,"['Action', 'Adventure', 'Sci-Fi']",9.0
1188,Dragonslayer,18000000,6000000,-12000000,-0.6666666666666666,False,11,['Documentary'],5.8
564,Dream House,50000000,41642166,-8357834,-0.16715668,False,9,"['Drama', 'Mystery', 'Thriller']",6.0
421,Dreamcatcher,68000000,75685268,7685268,0.11301864705882353,False,3,"['Crime', 'Documentary', 'Drama']",7.1
604,Dredd,45000000,41467606,-3532394,-0.07849764444444444,False,9,"['Action', 'Crime', 'Sci-Fi']",7.1
2105,Drinking Buddies,500000,407100,-92900,-0.1858,False,8,"['Comedy', 'Drama', 'Romance']",6.1
1256,Drive,15000000,81357930,66357930,4.423862,True,9,['Documentary'],6.3
568,Drive Angry,50000000,41042583,-8957417,-0.17914834,False,2,"['Action', 'Fantasy', 'Thriller']",5.4
1391,Drive Hard,12000000,0,-12000000,-1.0,False,10,"['Action', 'Comedy', 'Crime']",4.4
1580,Driving Miss Daisy,7500000,106593296,99093296,13.212439466666666,True,6,"['Comedy', 'Drama']",8.2
2116,Drones,500000,0,-500000,-1.0,False,1,['Comedy'],6.4
2097,Drunk Wedding,600000,3301,-596699,-0.9944983333333334,False,5,['Comedy'],4.6
2223,Dry Spell,22000,0,-22000,-1.0,False,2,"['Comedy', 'Romance']",3.3
432,Due Date,65000000,211739043,146739043,2.2575237384615385,True,11,"['Adventure', 'Comedy']",6.5
1664,Dum Maaro Dum,5200000,11633427,6433427,1.2371975,False,4,"['Action', 'Crime', 'Drama']",6.2
641,Dumb and Dumber To,40000000,156553592,116553592,2.9138398,True,11,"['Adventure', 'Comedy']",5.6
142,Dunkirk,150000000,499837368,349837368,2.33224912,True,7,"['Action', 'Drama', 'History']",7.9
1148,Dwegons and Leprechauns,20000000,0,-20000000,-1.0,False,1,['Animation'],4.2
1731,Dying of the Light,5000000,74639,-4925361,-0.9850722,False,12,"['Drama', 'Thriller']",4.4
1139,Dylan Dog: Dead of Night,20000000,6093725,-13906275,-0.69531375,False,11,"['Action', 'Comedy', 'Crime']",5.1
1969,Dysfunctional Friends,1800000,0,-1800000,-1.0,False,2,"['Comedy', 'Drama']",5.2
569,Early Man,50000000,45285890,-4714110,-0.0942822,False,2,"['Adventure', 'Animation', 'Comedy']",6.1
1323,Earth to Echo,13000000,42174545,29174545,2.2441957692307692,True,7,"['Adventure', 'Family', 'Sci-Fi']",5.8
1549,Easy A,8000000,76200721,68200721,8.525090125,True,9,"['Comedy', 'Drama', 'Romance']",7.1
458,Eat Pray Love,60000000,206598789,146598789,2.44331315,True,8,"['Drama', 'Romance']",5.8
2190,Echo Dr.,100000,0,-100000,-1.0,False,11,"['Action', 'Drama', 'Sci-Fi']",3.6
1027,Eddie the Eagle,23000000,45060480,22060480,0.9591513043478261,False,2,"['Biography', 'Comedy', 'Drama']",7.4
1999,Eddie: The Sleepwalking Cannibal,1400000,1632,-1398368,-0.9988342857142857,False,4,"['Comedy', 'Horror']",5.6
1895,Eden,2300000,0,-2300000,-1.0,False,10,"['Crime', 'Drama']",8.0
475,Edge of Darkness,60000000,82812456,22812456,0.3802076,False,1,"['Crime', 'Drama', 'Mystery']",6.6
84,Edge of Tomorrow,178000000,370541256,192541256,1.0816924494382023,False,6,"['Action', 'Sci-Fi']",7.9
1906,Eighth Grade,2000000,14341016,12341016,6.170508,True,7,"['Comedy', 'Drama']",7.5
1570,El Chicano,8000000,700261,-7299739,-0.912467375,False,5,['Drama'],5.7
442,Elektra,65000000,56824633,-8175367,-0.12577487692307693,False,9,"['Drama', 'Thriller']",6.1
1502,Elsa & Fred,10000000,197901,-9802099,-0.9802099,False,3,"['Comedy', 'Drama', 'Romance']",6.5
236,Elysium,120000000,286192091,166192091,1.3849340916666666,False,8,['Drama'],6.0
2220,Emily,27000,3547,-23453,-0.8686296296296296,False,6,['Drama'],6.8
1647,Emma,5900000,37831658,31931658,5.412145423728814,True,11,['Drama'],5.0
1252,End of Watch,15000000,57586606,42586606,2.8391070666666667,True,9,"['Action', 'Crime', 'Drama']",7.6
263,Ender's Game,110000000,127983283,17983283,0.16348439090909092,False,11,"['Action', 'Adventure', 'Fantasy']",6.6
1105,Endless Love,20000000,34718173,14718173,0.73590865,False,2,"['Drama', 'Romance']",6.3
1556,Enough Said,8000000,25621449,17621449,2.202681125,True,9,"['Comedy', 'Drama', 'Romance']",7.0
2118,Enter Nowhere,500000,0,-500000,-1.0,False,10,"['Mystery', 'Sci-Fi', 'Thriller']",6.6
1861,Enter the Dangerous Mind,3000000,0,-3000000,-1.0,False,3,['Thriller'],5.2
845,Entourage,30000000,46438538,16438538,0.5479512666666667,False,6,['Comedy'],6.6
278,Epic,100000000,262794441,162794441,1.62794441,False,5,"['Adventure', 'Animation', 'Family']",6.7
411,Escape Plan,70000000,103735965,33735965,0.48194235714285716,False,10,"['Action', 'Crime', 'Mystery']",6.7
2092,Escape from Tomorrow,650000,171962,-478038,-0.735443076923077,False,10,"['Drama', 'Fantasy', 'Horror']",5.2
1219,Escobar: Paradise Lost,17000000,3917679,-13082321,-0.769548294117647,False,10,"['Crime', 'Drama', 'History']",6.5
439,Everest,65000000,221297061,156297061,2.404570169230769,True,9,"['Action', 'Adventure', 'Biography']",7.1
1125,Everybody's Fine,20000000,9208876,-10791124,-0.5395562,False,1,['Drama'],5.9
1714,Everything Must Go,5000000,2821010,-2178990,-0.435798,False,5,"['Comedy', 'Drama']",6.4
1423,"Everything, Everything",10000000,61603136,51603136,5.1603136,True,5,"['Drama', 'Romance']",6.4
1211,Evil Dead,17000000,97778356,80778356,4.751668,True,4,"['Fantasy', 'Horror', 'Thriller']",6.5
365,Evolution,80000000,98341932,18341932,0.22927415,False,9,"['Drama', 'Mystery', 'Sci-Fi']",6.0
1324,Ex Machina,13000000,38358392,25358392,1.9506455384615384,False,4,"['Drama', 'Mystery', 'Sci-Fi']",7.7
2221,Exeter,25000,489792,464792,18.59168,True,3,['Horror'],5.7
165,Exodus: Gods and Kings,140000000,268314513,128314513,0.9165322357142857,False,12,"['Action', 'Adventure', 'Drama']",6.0
809,Extraordinary Measures,31000000,15826984,-15173016,-0.48945212903225804,False,1,['Drama'],6.5
1325,Eye in the Sky,13000000,35402802,22402802,1.7232924615384615,False,3,"['Drama', 'Thriller', 'War']",7.3
1704,Fahrenheit 11/9,5000000,6653715,1653715,0.330743,False,9,['Documentary'],6.7
567,Fair Game,50000000,26097497,-23902503,-0.47805006,False,5,['Documentary'],8.2
2101,Faith Connections,550000,9111,-540889,-0.9834345454545455,False,11,"['Biography', 'Documentary', 'Drama']",7.1
1750,Falcon Rising,4500000,11774,-4488226,-0.9973835555555556,False,9,"['Action', 'Adventure']",5.8
76,Fantastic Beasts and Where to Find Them,180000000,802402853,622402853,3.457793627777778,True,11,"['Adventure', 'Family', 'Fantasy']",7.3
53,Fantastic Beasts: The Crimes of Grindelwald,200000000,652220086,452220086,2.26110043,True,11,"['Adventure', 'Family', 'Fantasy']",6.6
241,Fantastic Four,120000000,167849187,47849187,0.398743225,False,8,"['Action', 'Adventure', 'Drama']",4.3
218,Fast Five,125000000,630163454,505163454,4.041307632,True,4,"['Action', 'Crime', 'Thriller']",7.3
1017,Faster,24000000,35792945,11792945,0.49137270833333335,False,11,"['Action', 'Crime', 'Drama']",6.5
1872,"Fat, Sick & Nearly Dead",2600000,0,-2600000,-1.0,False,4,['Documentary'],7.6
967,Father Figures,25000000,21038441,-3961559,-0.15846236,False,12,['Documentary'],6.8
346,Father's Day,85000000,35681080,-49318920,-0.5802225882352942,False,6,['Drama'],6.1
2064,Fear Clinic,1000000,0,-1000000,-1.0,False,10,['Horror'],5.0
1819,Feast,3200000,690872,-2509128,-0.7841025,False,11,['Horror'],7.8
1011,Fences,24000000,64282881,40282881,1.678453375,False,12,['Drama'],7.2
250,Ferdinand,111000000,289847930,178847930,1.6112426126126127,False,12,"['Adventure', 'Animation', 'Comedy']",6.7
499,Fifty Shades Darker,55000000,381398492,326398492,5.934518036363636,True,2,"['Drama', 'Romance']",4.6
504,Fifty Shades Freed,55000000,371350619,316350619,5.751829436363637,True,2,"['Drama', 'Romance', 'Thriller']",4.5
1701,Fifty Shades of Black,5000000,22113075,17113075,3.422615,True,1,['Comedy'],3.5
631,Fifty Shades of Grey,40000000,570998101,530998101,13.274952525,True,2,"['Drama', 'Romance', 'Thriller']",4.1
1149,Fight Valley,20000000,0,-20000000,-1.0,False,7,"['Action', 'Drama']",2.7
2126,Fight to the Finish,500000,0,-500000,-1.0,False,2,"['Action', 'Romance', 'Sport']",3.6
2006,Filly Brown,1250000,2940411,1690411,1.3523288,False,4,"['Drama', 'Music']",5.7
658,Final Destination 5,40000000,155011165,115011165,2.875279125,True,8,['Horror'],5.9
40,Finding Dory,200000000,1021215193,821215193,4.106075965,True,6,"['Adventure', 'Animation', 'Comedy']",7.3
474,First Man,60000000,105203825,45203825,0.7533970833333333,False,10,['Documentary'],6.6
1801,First Reformed,3500000,3874772,374772,0.10707771428571429,False,5,"['Drama', 'Mystery', 'Thriller']",7.1
958,Fist Fight,25000000,40286416,15286416,0.61145664,False,2,['Comedy'],5.6
917,Flatliners,26000000,61308153,35308153,1.3580058846153846,False,9,"['Drama', 'Horror', 'Mystery']",5.2
804,Flight,31000000,160558438,129558438,4.179304451612904,True,11,"['Drama', 'Thriller']",7.3
1306,Flipped,14000000,4289993,-9710007,-0.6935719285714286,False,12,"['Drama', 'Thriller']",6.0
890,Florence Foster Jenkins,29000000,56000339,27000339,0.9310461724137931,False,8,"['Biography', 'Comedy', 'Drama']",6.8
437,Focus,65000000,168065700,103065700,1.5856261538461538,False,2,['Comedy'],6.8
608,Foodfight!,45000000,73706,-44926294,-0.9983620888888889,False,5,"['Action', 'Animation', 'Comedy']",1.9
1013,Footloose,24000000,62989834,38989834,1.6245764166666667,False,10,"['Comedy', 'Drama', 'Music']",5.9
1059,For Colored Girls,21000000,38017873,17017873,0.8103749047619048,False,11,['Drama'],6.1
1378,For Greater Glory: The True Story of Cristiada,12000000,10026255,-1973745,-0.16447875,False,6,"['Drama', 'History', 'War']",6.6
2214,Foreign Letters,40000,0,-40000,-1.0,False,4,"['Comedy', 'Drama']",6.9
1799,Forever My Girl,3500000,16376066,12876066,3.678876,True,1,"['Drama', 'Music', 'Romance']",6.7
1202,Forsaken,18000000,0,-18000000,-1.0,False,2,['Drama'],4.6
1852,Fort McCoy,3000000,78948,-2921052,-0.973684,False,1,"['Drama', 'History', 'War']",5.9
1377,Fortress,12000000,46730578,34730578,2.8942148333333333,True,4,"['Documentary', 'Drama', 'News']",7.0
1789,Four Lions,3750000,2436111,-1313889,-0.3503704,False,11,"['Comedy', 'Crime', 'Drama']",7.3
1834,Frances Ha,3000000,11262769,8262769,2.754256333333333,True,5,"['Comedy', 'Drama', 'Romance']",7.4
600,Frankenstein,45000000,112006296,67006296,1.4890288,False,8,"['Drama', 'Horror']",1.9
690,Frankenweenie,39000000,81150788,42150788,1.080789435897436,False,10,"['Animation', 'Comedy', 'Family']",7.0
1867,Freakonomics,2900000,172867,-2727133,-0.9403906896551724,False,10,['Documentary'],6.4
789,Freaks of Nature,33000000,70958,-32929042,-0.9978497575757576,False,10,"['Comedy', 'Horror', 'Sci-Fi']",5.9
1645,Freaky Deaky,6000000,0,-6000000,-1.0,False,4,"['Comedy', 'Crime', 'Thriller']",6.1
507,Free Birds,55000000,110387072,55387072,1.0070376727272727,False,11,"['Adventure', 'Animation', 'Comedy']",5.9
1486,Free Fire,10000000,3793739,-6206261,-0.6206261,False,4,"['Action', 'Comedy', 'Crime']",6.4
565,Free State of Jones,50000000,23237252,-26762748,-0.53525496,False,6,"['Action', 'Biography', 'Drama']",6.9
1603,Freeheld,7000000,1732228,-5267772,-0.7525388571428572,False,10,"['Biography', 'Drama', 'Romance']",6.5
1800,Frenzy,3500000,12600000,9100000,2.6,True,8,['Thriller'],8.1
808,Frequency,31000000,68079671,37079671,1.1961184193548386,False,4,"['Sci-Fi', 'Thriller']",5.9
1516,Friend Request,9900000,11310835,1410835,0.14250858585858586,False,12,['Horror'],4.9
731,Friends with Benefits,35000000,146595891,111595891,3.1884540285714285,True,7,"['Comedy', 'Romance']",6.6
862,Fright Night,30000000,40520649,10520649,0.3506883,False,8,"['Comedy', 'Horror']",6.4
1891,Frontera,2300000,59696,-2240304,-0.9740452173913043,False,9,['Drama'],6.3
136,Frozen,150000000,1272469910,1122469910,7.483132733333333,True,11,"['Fantasy', 'Romance']",5.4
2075,Fruitvale Station,900000,17549645,16649645,18.499605555555554,True,7,"['Biography', 'Drama', 'Romance']",7.5
1302,Fun Size,14000000,11166615,-2833385,-0.20238464285714286,False,10,"['Adventure', 'Comedy']",5.4
59,Furious 7,190000000,1518722794,1328722794,6.9932778631578945,True,4,"['Action', 'Crime', 'Thriller']",7.2
761,Furry Vengeance,35000000,39340177,4340177,0.12400505714285714,False,4,"['Comedy', 'Family']",3.8
360,Fury,80000000,210315681,130315681,1.6289460125,False,10,"['Action', 'Drama', 'War']",7.6
164,G.I. Joe: Retaliation,140000000,375740705,235740705,1.6838621785714285,False,3,"['Action', 'Adventure', 'Sci-Fi']",5.8
711,Game Night,37000000,117378084,80378084,2.1723806486486485,True,2,"['Action', 'Comedy', 'Crime']",7.0
472,Gangster Squad,60000000,104100903,44100903,0.73501505,False,1,"['Action', 'Crime', 'Drama']",6.7
1218,Genius,17000000,7265283,-9734717,-0.5726304117647059,False,6,['Drama'],5.4
286,Geostorm,100000000,220796009,120796009,1.20796009,False,10,"['Action', 'Sci-Fi', 'Thriller']",5.3
638,Get Hard,40000000,106511453,66511453,1.662786325,False,3,"['Comedy', 'Crime']",6.0
652,Get Him to the Greek,40000000,91455875,51455875,1.286396875,False,6,"['Adventure', 'Comedy', 'Music']",6.4
1665,Get Out,5000000,255367951,250367951,50.0735902,True,2,"['Horror', 'Mystery', 'Thriller']",7.7
851,Get on Up,30000000,33339868,3339868,0.11132893333333334,False,8,"['Biography', 'Drama', 'Music']",6.9
1187,Getaway,18000000,11813989,-6186011,-0.3436672777777778,False,8,"['Action', 'Crime', 'Thriller']",4.4
1035,Ghost,22000000,517600000,495600000,22.527272727272727,True,4,['Horror'],2.3
496,Ghost Rider: Spirit of Vengeance,57000000,149217355,92217355,1.6178483333333333,False,12,"['Action', 'Fantasy', 'Thriller']",4.3
264,Ghost in the Shell,110000000,167910690,57910690,0.5264608181818182,False,3,"['Action', 'Drama', 'Sci-Fi']",6.4
160,Ghostbusters,144000000,229008658,85008658,0.5903379027777778,False,7,"['Action', 'Comedy', 'Fantasy']",5.2
1590,Gifted,7000000,36964656,29964656,4.280665142857143,True,4,['Documentary'],7.0
2120,Girls Gone Dead,500000,0,-500000,-1.0,False,3,"['Comedy', 'Horror']",3.5
894,Girls Trip,28000000,140886353,112886353,4.0316554642857145,True,7,"['Comedy', 'Drama']",6.2
2164,Give Me Shelter,250000,0,-250000,-1.0,False,6,['Documentary'],7.6
876,Gloria,30000000,4967493,-25032507,-0.8344169,False,1,"['Biography', 'Drama', 'Music']",6.5
167,Gods of Egypt,140000000,138836756,-1163244,-0.008308885714285714,False,2,"['Action', 'Adventure', 'Fantasy']",5.4
123,Godzilla,160000000,529076069,369076069,2.30672543125,True,5,"['Action', 'Adventure', 'Sci-Fi']",6.4
1015,Going in Style,24000000,78672579,54672579,2.278024125,True,4,"['Comedy', 'Crime']",6.6
800,Going the Distance,32000000,43603990,11603990,0.3626246875,False,9,['nan'],3.9
452,Gone Girl,61000000,368567189,307567189,5.042085065573771,True,10,"['Drama', 'Mystery', 'Thriller']",8.1
1511,Good Intentions,10000000,0,-10000000,-1.0,False,3,['Comedy'],5.2
490,Goosebumps,58000000,158905324,100905324,1.7397469655172413,False,10,"['Adventure', 'Comedy', 'Family']",6.3
736,Goosebumps 2: Haunted Halloween,35000000,93291478,58291478,1.6654708,False,10,"['Adventure', 'Comedy', 'Family']",5.6
1473,Gotti,10000000,6089100,-3910900,-0.39109,False,6,"['Biography', 'Crime', 'Drama']",4.8
1662,Grabbers,5300000,440821,-4859179,-0.9168262264150944,False,7,"['Comedy', 'Horror', 'Sci-Fi']",6.3
1726,Grace,5000000,8297,-4991703,-0.9983406,False,10,"['Crime', 'Drama', 'Horror']",6.5
1973,Grace Unplugged,1700000,2507159,807159,0.47479941176470586,False,10,"['Drama', 'Music']",6.2
882,Grace of Monaco,30000000,25199891,-4800109,-0.16000363333333334,False,6,"['Biography', 'Drama', 'Romance']",5.7
2146,Graduation Day,250000,23894000,23644000,94.576,True,1,['Thriller'],5.0
1938,Grave Encounters,2000000,2151887,151887,0.0759435,False,9,['Horror'],6.1
253,Gravity,110000000,693698673,583698673,5.306351572727273,True,10,"['Drama', 'Sci-Fi', 'Thriller']",7.7
1536,Greater,9000000,2000093,-6999907,-0.7777674444444445,False,8,"['Biography', 'Family', 'Sport']",7.2
1020,Green Book,23000000,322034439,299034439,13.001497347826087,True,11,"['Biography', 'Comedy', 'Drama']",8.3
54,Green Lantern,200000000,219535492,19535492,0.09767746,False,6,"['Action', 'Adventure', 'Sci-Fi']",5.5
1709,Green Room,5000000,3807503,-1192497,-0.2384994,False,4,"['Horror', 'Music', 'Thriller']",7.0
285,Green Zone,100000000,97523020,-2476980,-0.0247698,False,3,"['Action', 'Drama', 'Thriller']",6.8
1868,Griff the Invisible,2900000,25935,-2874065,-0.9910568965517241,False,8,"['Comedy', 'Drama', 'Romance']",6.1
381,Grown Ups,75000000,272223430,197223430,2.629645733333333,True,6,['Comedy'],6.0
355,Grown Ups 2,80000000,247023808,167023808,2.0877976,True,7,['Comedy'],5.4
671,Grudge Match,40000000,69807260,29807260,0.7451815,False,12,"['Comedy', 'Drama', 'Sport']",6.4
97,Guardians of the Galaxy,170000000,770867516,600867516,3.5345148,True,8,"['Action', 'Adventure', 'Comedy']",8.1
249,Gulliver's Travels,112000000,232017848,120017848,1.0715879285714285,False,12,"['Adventure', 'Comedy', 'Family']",4.9
1489,Gun Shy,10000000,1638202,-8361798,-0.8361798,False,9,"['Action', 'Adventure', 'Comedy']",4.1
2173,H.,200000,0,-200000,-1.0,False,9,"['Drama', 'Sci-Fi', 'Thriller']",5.9
648,Hacksaw Ridge,40000000,168904682,128904682,3.22261705,True,11,"['Biography', 'Drama', 'History']",8.1
1041,"Hail, Caesar!",22000000,64160680,42160680,1.9163945454545455,False,2,"['Comedy', 'Drama', 'Music']",6.3
420,Hall Pass,68000000,87173475,19173475,0.2819628676470588,False,2,"['Comedy', 'Romance']",5.9
1241,Halloween,15000000,77514401,62514401,4.167626733333333,True,10,"['Horror', 'Thriller']",6.6
1135,Hands of Stone,20000000,5031975,-14968025,-0.74840125,False,8,"['Action', 'Biography', 'Drama']",6.6
834,Hanna,30000000,65343694,35343694,1.1781231333333333,False,4,"['Action', 'Drama', 'Thriller']",6.8
545,Hansel & Gretel: Witch Hunters,50000000,214949716,164949716,3.29899432,True,1,"['Action', 'Fantasy', 'Horror']",6.1
1839,Happiness,3000000,5746453,2746453,0.9154843333333333,False,1,['Drama'],6.3
2216,Happy 40th,35000,0,-35000,-1.0,False,5,['Drama'],6.3
2198,Happy Christmas,70000,30312,-39688,-0.5669714285714286,False,6,"['Comedy', 'Drama']",5.5
1676,Happy Death Day,5000000,125010260,120010260,24.002052,True,10,"['Horror', 'Mystery', 'Thriller']",6.5
174,Happy Feet Two,135000000,157956466,22956466,0.1700478962962963,False,11,"['Adventure', 'Animation', 'Comedy']",5.9
2152,Happy Valley,250000,67665,-182335,-0.72934,False,11,"['Documentary', 'Drama', 'Sport']",7.1
1908,Hardcore Henry,2000000,17187434,15187434,7.593717,True,4,"['Action', 'Adventure', 'Sci-Fi']",6.7
2049,Hardflip,1000000,96734,-903266,-0.903266,False,6,"['Action', 'Drama']",5.6
2202,Hayride,60000,0,-60000,-1.0,False,10,"['Crime', 'Drama', 'Horror']",3.4
1026,Haywire,23000000,36374700,13374700,0.5815086956521739,False,11,"['Action', 'Drama', 'Thriller']",5.8
1918,Hearts Beat Loud,2000000,2420962,420962,0.210481,False,6,"['Comedy', 'Drama', 'Music']",6.9
753,Heist,35000000,28906817,-6093183,-0.17409094285714286,False,11,['Action'],6.4
2057,Heli,1000000,552614,-447386,-0.447386,False,10,"['Crime', 'Drama', 'Romance']",6.8
1653,Hell Fest,5500000,18119231,12619231,2.2944056363636363,True,9,['Horror'],5.5
1363,Hell or High Water,12000000,37584304,25584304,2.1320253333333334,True,8,"['Action', 'Crime', 'Drama']",7.6
1734,Henry & Me,5000000,0,-5000000,-1.0,False,8,"['Animation', 'Family']",6.2
1024,Her,23000000,48163815,25163815,1.0940789130434783,False,12,"['Drama', 'Romance', 'Sci-Fi']",8.0
2215,Her Cry: La Llorona Investigation,35000,0,-35000,-1.0,False,4,['Horror'],3.7
280,Hercules,100000000,243388614,143388614,1.43388614,False,7,['Comedy'],6.2
619,Here Comes the Boom,42000000,73239258,31239258,0.7437918571428571,False,10,"['Action', 'Comedy', 'Sport']",6.4
555,Hereafter,50000000,108660270,58660270,1.1732054,False,10,"['Drama', 'Fantasy', 'Romance']",6.5
1418,Hereditary,10000000,70133905,60133905,6.0133905,True,6,"['Drama', 'Horror', 'Mystery']",7.3
625,Hero,42000000,66787173,24787173,0.5901707857142857,False,1,['Drama'],6.4
1606,Hesher,7000000,382946,-6617054,-0.9452934285714286,False,1,"['Comedy', 'Crime', 'Drama']",7.0
2061,Hidden Away,1000000,0,-1000000,-1.0,False,10,"['Drama', 'Romance']",7.1
936,Hidden Figures,25000000,231771716,206771716,8.27086864,True,12,"['Biography', 'Drama', 'History']",7.8
948,Hide and Seek,25000000,123696741,98696741,3.94786964,True,10,['Comedy'],6.6
2102,High Road,546173,0,-546173,-1.0,False,3,['Comedy'],5.4
1499,High School,10000000,248133,-9751867,-0.9751867,False,6,['Comedy'],5.8
1966,Higher Ground,1800000,842693,-957307,-0.5318372222222222,False,8,['Drama'],6.3
2115,Higher Power,500000,528,-499472,-0.998944,False,5,"['Action', 'Sci-Fi', 'Thriller']",5.3
1947,Highway,2000000,0,-2000000,-1.0,False,2,['Drama'],6.2
1045,Hit & Run,22000000,17216955,-4783045,-0.21741113636363638,False,8,"['Action', 'Comedy']",7.1
757,Hitman: Agent 47,35000000,82182803,47182803,1.3480800857142856,False,8,"['Action', 'Adventure', 'Crime']",5.7
2053,Hits,1000000,15156,-984844,-0.984844,False,1,"['Comedy', 'Drama']",5.8
1845,Hobo with a Shotgun,3000000,834953,-2165047,-0.7216823333333333,False,5,"['Action', 'Comedy', 'Horror']",6.1
621,Holmes & Watson,42000000,41926605,-73395,-0.0017475,False,12,"['Adventure', 'Comedy', 'Crime']",3.8
1770,Holy Motors,4000000,4230426,230426,0.0576065,False,10,"['Drama', 'Fantasy']",7.1
181,Home,130000000,385997896,255997896,1.9692145846153846,False,11,"['Drama', 'Romance', 'Thriller']",8.4
1259,Home Again,15000000,37336874,22336874,1.4891249333333334,False,9,['Drama'],6.6
2008,Home Run,1200000,2859955,1659955,1.3832958333333334,False,4,"['Drama', 'Family', 'Sport']",4.2
1043,Homefront,22000000,51695362,29695362,1.3497891818181817,False,11,['Drama'],7.7
1177,Honey,18000000,62646763,44646763,2.480375722222222,True,3,"['Drama', 'Romance']",7.3
448,Hop,63000000,188657593,125657593,1.9945649682539683,False,4,"['Adventure', 'Animation', 'Comedy']",5.4
817,Hope Springs,30000000,133085295,103085295,3.4361765,True,8,"['Comedy', 'Drama', 'Romance']",6.3
725,Horrible Bosses,35000000,212417601,177417601,5.069074314285714,True,7,"['Comedy', 'Crime']",6.9
654,Horrible Bosses 2,40000000,105945357,65945357,1.648633925,False,11,"['Comedy', 'Crime']",6.3
2162,Horse Camp,250000,0,-250000,-1.0,False,1,['Family'],6.7
391,Hostage,75000000,77636443,2636443,0.03515257333333333,False,9,"['Comedy', 'Drama', 'History']",6.3
742,Hot Pursuit,35000000,45671512,10671512,0.30490034285714285,False,5,"['Action', 'Comedy', 'Crime']",5.1
715,Hot Tub Time Machine,36000000,65967750,29967750,0.8324375,False,3,"['Comedy', 'Sci-Fi']",6.4
1300,Hot Tub Time Machine 2,14000000,12826644,-1173356,-0.08381114285714286,False,2,"['Comedy', 'Mystery', 'Sci-Fi']",5.1
1274,Hotel Artemis,15000000,12758799,-2241201,-0.1494134,False,6,"['Action', 'Drama', 'Sci-Fi']",6.1
339,Hotel Transylvania,85000000,378505812,293505812,3.4530095529411766,True,9,"['Animation', 'Comedy', 'Family']",7.1
354,Hotel Transylvania 2,80000000,469500298,389500298,4.868753725,True,9,"['Animation', 'Comedy', 'Family']",6.7
430,Hotel Transylvania 3: Summer Vacation,65000000,527079962,462079962,7.108922492307692,True,6,"['Adventure', 'Animation', 'Comedy']",6.3
2001,House at the End of the Drive,1400000,0,-1400000,-1.0,False,1,"['Horror', 'Thriller']",6.5
1610,House at the End of the Street,6900000,44103982,37203982,5.391881449275362,True,9,"['Drama', 'Horror', 'Thriller']",5.6
1991,Housebound,1500000,236863,-1263137,-0.8420913333333333,False,10,"['Comedy', 'Horror', 'Mystery']",6.8
1426,How to Be a Latin Lover,10000000,62556228,52556228,5.2556228,True,4,"['Comedy', 'Drama']",5.9
109,How to Train Your Dragon,165000000,494870992,329870992,1.9992181333333334,False,3,"['Action', 'Adventure', 'Animation']",8.1
156,How to Train Your Dragon 2,145000000,614586270,469586270,3.238526,True,6,"['Action', 'Adventure', 'Animation']",7.8
79,Hugo,180000000,180047784,47784,0.00026546666666666665,False,11,['Documentary'],7.9
1876,Hunt for the Wilderpeople,2500000,23845533,21345533,8.5382132,True,6,"['Adventure', 'Comedy', 'Drama']",7.9
2065,Hush,1000000,0,-1000000,-1.0,False,3,['Documentary'],4.8
2030,I Am Not Your Negro,1000000,9617402,8617402,8.617402,True,2,['Documentary'],7.8
1197,I Am Wrath,18000000,309608,-17690392,-0.9827995555555555,False,5,"['Action', 'Crime', 'Drama']",5.4
1588,I Can Only Imagine,7000000,85604221,78604221,11.22917442857143,True,3,"['Biography', 'Drama', 'Family']",7.4
1018,I Don't Know How She Does It,24000000,24474463,474463,0.019769291666666668,False,9,"['Comedy', 'Romance']",4.9
796,I Feel Pretty,32000000,91553797,59553797,1.86105615625,False,4,"['Comedy', 'Romance']",5.4
2046,I Origins,1000000,852399,-147601,-0.147601,False,7,"['Drama', 'Romance', 'Sci-Fi']",7.4
1971,I Spit on Your Grave,1750000,1278471,-471529,-0.2694451428571429,False,10,"['Horror', 'Thriller']",6.3
2132,I Want Your Money,400000,433588,33588,0.08397,False,7,['Documentary'],5.1
443,"I, Frankenstein",65000000,74575290,9575290,0.14731215384615384,False,1,"['Action', 'Fantasy', 'Horror']",5.1
1400,"I, Tonya",11000000,53797409,42797409,3.8906735454545456,True,12,"['Biography', 'Comedy', 'Drama']",7.5
1643,Icarus,6000000,0,-6000000,-1.0,False,4,"['Documentary', 'Sport', 'Thriller']",7.9
269,Ice Age: Collision Course,105000000,402156682,297156682,2.830063638095238,True,7,"['Adventure', 'Animation', 'Comedy']",5.7
302,Ice Age: Continental Drift,95000000,879765137,784765137,8.26068565263158,True,7,"['Adventure', 'Animation', 'Comedy']",6.6
1871,Ida,2600000,15298355,12698355,4.8839826923076926,True,5,['Drama'],7.4
903,Identity,28000000,82183683,54183683,1.9351315357142858,False,5,"['Crime', 'Drama']",6.6
724,Identity Thief,35000000,175361578,140361578,4.0103308,True,2,"['Adventure', 'Comedy', 'Crime']",5.7
1371,If Beale Street Could Talk,12000000,19859167,7859167,0.6549305833333333,False,12,"['Drama', 'Romance']",7.2
1396,If I Stay,11000000,78356170,67356170,6.1232881818181815,True,8,"['Drama', 'Fantasy', 'Music']",6.8
384,Immortals,75000000,211562435,136562435,1.8208324666666666,False,11,"['Action', 'Drama', 'Fantasy']",6.0
1290,In Dubious Battle,15000000,214182,-14785818,-0.9857212,False,2,['Drama'],6.1
739,In Time,35000000,165103952,130103952,3.7172557714285714,True,10,"['Action', 'Crime', 'Drama']",6.7
290,In the Heart of the Sea,100000000,89693309,-10306691,-0.10306691,False,12,"['Action', 'Adventure', 'Biography']",6.9
1707,Incarnate,5000000,9371036,4371036,0.8742072,False,12,"['Horror', 'Thriller']",5.3
1611,Incendies,6800000,16038343,9238343,1.3585798529411766,False,9,"['Drama', 'Mystery', 'War']",8.3
120,Inception,160000000,835524642,675524642,4.2220290125,True,7,"['Action', 'Adventure', 'Sci-Fi']",8.8
37,Incredibles 2,200000000,1242520711,1042520711,5.212603555,True,6,"['Action', 'Adventure', 'Animation']",7.7
112,Independence Day: Resurgence,165000000,384169424,219169424,1.3282995393939394,False,6,"['Action', 'Adventure', 'Sci-Fi']",5.2
1970,Independence Daysaster,1800000,0,-1800000,-1.0,False,6,"['Action', 'Adventure', 'Sci-Fi']",3.4
2189,Indie Game: The Movie,100000,0,-100000,-1.0,False,5,"['Documentary', 'Drama']",7.7
1869,Indivisible,2700000,3588305,888305,0.3290018518518519,False,10,['Documentary'],7.2
1783,Inescapable,4000000,4327,-3995673,-0.99891825,False,2,"['Action', 'Drama', 'Mystery']",5.2
1901,Infected,2100000,0,-2100000,-1.0,False,10,"['Action', 'Horror', 'Sci-Fi']",3.8
392,Inferno,75000000,219519367,144519367,1.9269248933333334,False,10,['Thriller'],6.3
1127,Inherent Vice,20000000,14772346,-5227654,-0.2613827,False,1,"['Comedy', 'Crime', 'Drama']",6.7
1913,Inside Job,2000000,7799257,5799257,2.8996285,True,10,"['Crime', 'Documentary']",8.3
1403,Inside Llewyn Davis,11000000,32943247,21943247,1.9948406363636364,False,12,"['Drama', 'Music']",7.5
88,Inside Out,175000000,854235992,679235992,3.881348525714286,True,6,['Family'],7.3
1978,Insidious,1500000,99870886,98370886,65.58059066666667,True,4,"['Horror', 'Mystery', 'Thriller']",6.9
1414,Insidious: The Last Key,10000000,167885588,157885588,15.7885588,True,1,"['Horror', 'Mystery', 'Thriller']",5.7
578,Instant Family,48000000,119736188,71736188,1.4945039166666667,False,11,"['Comedy', 'Drama']",7.4
111,Interstellar,165000000,666379375,501379375,3.038662878787879,True,11,"['Adventure', 'Drama', 'Sci-Fi']",8.6
1514,Into the Grizzly Maze,10000000,0,-10000000,-1.0,False,6,"['Action', 'Adventure', 'Drama']",5.3
549,Into the Storm,50000000,150429371,100429371,2.00858742,True,8,"['Action', 'Adventure', 'Drama']",5.8
497,Into the Woods,56200000,213116401,156916401,2.7921067793594307,True,12,"['Comedy', 'Musical']",7.8
1654,Iris,5500000,5580479,80479,0.014632545454545455,False,10,"['Drama', 'Family', 'History']",5.8
98,Iron Man 2,170000000,621156389,451156389,2.653861111764706,True,5,"['Action', 'Adventure', 'Sci-Fi']",7.0
42,Iron Man 3,200000000,1215392272,1015392272,5.07696136,True,5,"['Action', 'Adventure', 'Sci-Fi']",7.2
1004,Ironclad,25000000,5297411,-19702589,-0.78810356,False,7,"['Action', 'Adventure', 'Drama']",6.2
721,It,35000000,697457969,662457969,18.927370542857144,True,9,"['Horror', 'Thriller']",7.4
1699,It Comes at Night,5000000,19720203,14720203,2.9440406,True,6,"['Horror', 'Mystery']",6.2
1904,It Follows,2000000,23250755,21250755,10.6253775,True,3,"['Horror', 'Mystery']",6.9
1560,It's Kind of a Funny Story,8000000,6632950,-1367050,-0.17088125,False,10,"['Comedy', 'Drama', 'Romance']",7.1
1508,It's a Wonderful Afterlife,10000000,1642939,-8357061,-0.8357061,False,10,"['Comedy', 'Drama', 'Fantasy']",5.4
740,J. Edgar,35000000,84606030,49606030,1.4173151428571429,False,11,"['Biography', 'Crime', 'Drama']",6.6
1522,Jab Tak Hai Jaan,9200000,5806666,-3393334,-0.36884065217391304,False,11,"['Drama', 'Romance']",6.8
459,Jack Reacher,60000000,217370736,157370736,2.6228456,True,12,"['Action', 'Crime', 'Thriller']",7.0
462,Jack Reacher: Never Go Back,60000000,159946489,99946489,1.6657748166666666,False,10,"['Action', 'Thriller']",6.1
469,Jack Ryan: Shadow Recruit,60000000,131377412,71377412,1.1896235333333334,False,1,"['Action', 'Drama', 'Thriller']",6.2
372,Jack and Jill,79000000,150519217,71519217,0.9053065443037974,False,11,['Comedy'],3.3
58,Jack the Giant Slayer,195000000,197687603,2687603,0.013782579487179487,False,3,"['Adventure', 'Fantasy']",6.3
1070,Jackass 3D,20000000,171685793,151685793,7.58428965,True,10,"['Action', 'Comedy', 'Documentary']",7.0
1531,Jackie,9000000,36588512,27588512,3.0653902222222222,True,12,['Action'],7.1
2134,Jackpot,400000,44452,-355548,-0.88887,False,6,"['Comedy', 'Romance']",7.8
1001,Jane Got a Gun,25000000,3771345,-21228655,-0.8491462,False,1,"['Action', 'Drama', 'Western']",5.9
233,Jason Bourne,120000000,416168316,296168316,2.4680693,True,7,"['Action', 'Thriller']",6.6
1474,"Jeff, Who Lives at Home",10000000,4708127,-5291873,-0.5291873,False,9,"['Comedy', 'Drama']",6.5
1717,Jem and the Holograms,5000000,2368937,-2631063,-0.5262126,False,10,"['Adventure', 'Drama', 'Family']",4.1
657,Jersey Boys,40000000,65282732,25282732,0.6320683,False,6,"['Biography', 'Drama', 'Music']",6.8
1420,Jigsaw,10000000,102445196,92445196,9.2445196,True,10,"['Crime', 'Horror', 'Mystery']",5.8
1184,Jobs,18000000,43402515,25402515,1.4112508333333333,False,8,"['Biography', 'Drama']",5.9
1776,Joe,4000000,373375,-3626625,-0.90665625,False,4,"['Crime', 'Drama']",6.9
11,John Carter,275000000,282778100,7778100,0.028284,False,3,"['Action', 'Adventure', 'Sci-Fi']",6.6
829,John Wick,30000000,76235001,46235001,1.5411667,False,10,"['Action', 'Crime', 'Thriller']",7.4
607,Johnny English Reborn,45000000,164640401,119640401,2.6586755777777777,True,10,"['Action', 'Adventure', 'Comedy']",6.3
583,Jonah Hex,47000000,11022696,-35977304,-0.7654745531914894,False,6,"['Action', 'Drama', 'Fantasy']",4.7
371,Journey 2: The Mysterious Island,79000000,318146162,239146162,3.027166607594937,True,2,"['Action', 'Adventure', 'Comedy']",5.8
465,Joy,60000000,101134059,41134059,0.68556765,False,12,['nan'],5.8
913,Joyful Noise,27500000,31157914,3657914,0.13301505454545454,False,1,"['Comedy', 'Drama', 'Music']",5.8
1638,Julia,6000000,1365108,-4634892,-0.772482,False,10,['Documentary'],7.2
316,Jumanji: Welcome to the Jungle,90000000,964496193,874496193,9.716624366666666,True,12,"['Action', 'Adventure', 'Comedy']",7.0
1589,Jumping the Broom,7000000,38158601,31158601,4.4512287142857145,True,5,"['Comedy', 'Drama']",5.7
81,Jupiter Ascending,179000000,181982519,2982519,0.016662117318435754,False,2,"['Action', 'Adventure', 'Sci-Fi']",5.3
26,Jurassic World,215000000,1648854864,1433854864,6.669092390697674,True,6,"['Action', 'Adventure', 'Sci-Fi']",7.0
96,Jurassic World: Fallen Kingdom,170000000,1305772799,1135772799,6.681016464705882,True,6,"['Action', 'Adventure', 'Sci-Fi']",6.2
1049,Just Getting Started,22000000,6756412,-15243588,-0.6928903636363636,False,12,"['Action', 'Comedy']",4.4
1367,Just Wright,12000000,21867665,9867665,0.8223054166666667,False,5,"['Comedy', 'Romance', 'Sport']",5.9
4,Justice League,300000000,655945209,355945209,1.18648403,False,11,"['Action', 'Adventure', 'Fantasy']",6.5
1317,Justin Bieber: Never Say Never,13000000,99034125,86034125,6.618009615384615,True,2,"['Documentary', 'Music']",1.6
1364,Katy Perry: Part of Me,12000000,32700439,20700439,1.7250365833333334,False,7,"['Documentary', 'Music']",5.9
1263,Keanu,15000000,20688141,5688141,0.3792094,False,4,"['Action', 'Comedy', 'Crime']",6.3
2086,Kevin Hart: Laugh at My Pain,750000,7712436,6962436,9.283248,True,9,"['Comedy', 'Documentary']",7.4
1874,Kevin Hart: Let Me Explain,2500000,32327255,29827255,11.930902,True,7,"['Comedy', 'Documentary']",6.8
1435,Kevin Hart: What Now?,10000000,23591043,13591043,1.3591043,False,10,"['Comedy', 'Documentary']",5.9
1651,Khiladi 786,5600000,14683763,9083763,1.6221005357142857,False,12,"['Action', 'Comedy']",4.4
1288,Khumba,15000000,20898221,5898221,0.39321473333333334,False,12,"['Adventure', 'Animation', 'Family']",5.7
904,Kick-Ass,28000000,97531134,69531134,2.4832547857142857,True,4,"['Action', 'Comedy']",7.6
907,Kick-Ass 2,28000000,63129909,35129909,1.2546396071428572,False,8,"['Action', 'Comedy', 'Crime']",6.6
1498,Kicks,10000000,150191,-9849809,-0.9849809,False,9,"['Adventure', 'Drama']",6.3
1060,Kidnap,21000000,34836080,13836080,0.6588609523809524,False,8,['Drama'],7.5
2083,Kill List,800000,462206,-337794,-0.4222425,False,1,"['Crime', 'Drama', 'Horror']",6.4
1382,Kill the Irishman,12000000,1188194,-10811806,-0.9009838333333333,False,3,"['Biography', 'Crime', 'Drama']",7.1
1715,Kill the Messenger,5000000,6656705,1656705,0.331341,False,10,"['Biography', 'Crime', 'Drama']",7.0
412,Killer Elite,70000000,65409046,-4590954,-0.06558505714285714,False,9,"['Action', 'Crime', 'Thriller']",6.5
1492,Killer Joe,10000000,4659110,-5340890,-0.534089,False,7,"['Crime', 'Drama', 'Thriller']",6.7
389,Killers,75000000,95572749,20572749,0.27430332,False,6,"['Action', 'Crime', 'Drama']",6.5
1268,Killing Them Softly,15000000,39238443,24238443,1.6158962,False,11,"['Crime', 'Thriller']",6.2
874,Kin,30000000,10096821,-19903179,-0.6634393,False,8,"['Drama', 'Music']",8.6
94,King Arthur: Legend of the Sword,175000000,139630336,-35369664,-0.2021123657142857,False,5,"['Action', 'Adventure', 'Drama']",6.8
1591,Kingdom Come,7000000,23393939,16393939,2.3419912857142857,True,1,"['Drama', 'Thriller']",8.3
270,Kingsman: The Golden Circle,104000000,408803696,304803696,2.930804769230769,True,9,"['Action', 'Adventure', 'Comedy']",6.8
311,Kingsman: The Secret Service,94000000,404561724,310561724,3.3038481276595744,True,2,"['Action', 'Adventure', 'Comedy']",7.7
1523,Kites,9200000,17155193,7955193,0.8646948913043478,False,5,"['Action', 'Drama', 'Romance']",6.1
243,Knight and Day,117000000,258751370,141751370,1.211550170940171,False,6,"['Action', 'Adventure', 'Comedy']",6.3
1931,Knock Knock,2000000,6328516,4328516,2.164258,True,10,['Horror'],6.0
69,Kong: Skull Island,185000000,561072059,376072059,2.0328219405405403,True,3,"['Action', 'Adventure', 'Fantasy']",6.6
1251,Krampus,15000000,61788393,46788393,3.1192262,True,12,"['Comedy', 'Fantasy', 'Horror']",6.2
2217,Krisha,30000,144822,114822,3.8274,True,3,['Drama'],7.2
509,Kubo and the Two Strings,55000000,77548122,22548122,0.40996585454545453,False,8,"['Action', 'Adventure', 'Animation']",7.8
144,Kung Fu Panda 2,150000000,664837547,514837547,3.4322503133333333,True,5,"['Action', 'Adventure', 'Animation']",7.2
163,Kung Fu Panda 3,140000000,517599142,377599142,2.6971367285714285,True,1,"['Action', 'Adventure', 'Animation']",7.1
2071,L!fe Happens,930000,30905,-899095,-0.9667688172043011,False,6,['Comedy'],5.6
1138,LBJ,20000000,2507181,-17492819,-0.87464095,False,11,"['Biography', 'Drama', 'History']",6.5
1407,LOL,11000000,10431506,-568494,-0.05168127272727273,False,5,"['Comedy', 'Drama', 'Romance']",4.4
1065,La La Land,20000000,426351163,406351163,20.31755815,True,12,"['Comedy', 'Drama', 'Music']",8.0
1186,Labor Day,18000000,14189810,-3810190,-0.2116772222222222,False,12,"['Drama', 'Romance']",6.9
1415,Lady Bird,10000000,78610769,68610769,6.8610769,True,11,"['Comedy', 'Drama']",7.4
839,Larry Crowne,30000000,61449135,31449135,1.0483045,False,6,"['Comedy', 'Drama', 'Romance']",6.1
426,Last Man Standing,67000000,18115927,-48884073,-0.7296130298507463,False,6,['Comedy'],6.8
900,Last Vegas,28000000,112914167,84914167,3.0326488214285714,True,11,"['Comedy', 'Drama']",6.6
923,Lawless,26000000,54393687,28393687,1.0920648846153846,False,8,"['Crime', 'Drama']",7.3
1657,Le Havre,5500000,13480196,7980196,1.4509447272727272,False,10,"['Comedy', 'Drama']",7.2
1567,Lean on Pete,8000000,2455027,-5544973,-0.693121625,False,4,"['Adventure', 'Drama']",7.2
1159,Leap Year,19000000,32618920,13618920,0.7167852631578947,False,1,"['Drama', 'Romance']",5.9
1166,Left Behind,18500000,4221341,-14278659,-0.7718194054054054,False,10,"['Horror', 'Mystery', 'Thriller']",6.5
973,Legend,25000000,23506237,-1493763,-0.05975052,False,11,"['Action', 'Drama']",6.5
283,Legend of the Guardians: The Owls of Ga'Hoole,100000000,139716717,39716717,0.39716717,False,9,"['Action', 'Adventure', 'Animation']",7.0
921,Legion,26000000,67647574,41647574,1.6018297692307693,False,1,"['Action', 'Fantasy', 'Horror']",5.2
1120,Let Me In,20000000,28270399,8270399,0.41351995,False,10,['Horror'],5.1
1831,Let There Be Light,3000000,7241309,4241309,1.4137696666666666,False,10,['Documentary'],6.7
1735,Let's Kill Ward's Wife,5000000,0,-5000000,-1.0,False,12,"['Comedy', 'Crime']",5.4
1838,Letters to God,3000000,3237452,237452,0.07915066666666666,False,4,"['Drama', 'Family']",6.3
822,Letters to Juliet,30000000,82148538,52148538,1.7382846,False,5,"['Adventure', 'Comedy', 'Drama']",6.6
385,Life,75000000,73521587,-1478413,-0.019712173333333333,False,12,['Documentary'],7.8
234,Life of Pi,120000000,620912003,500912003,4.174266691666666,True,11,"['Adventure', 'Drama', 'Fantasy']",7.9
821,Life of the Party,30000000,65759911,35759911,1.1919970333333334,False,5,"['Comedy', 'Drama']",7.6
1673,Lights Out,5000000,148806510,143806510,28.761302,True,7,['Drama'],6.6
2149,Like Crazy,250000,3728400,3478400,13.9136,True,10,"['Comedy', 'Drama']",7.2
1548,Limbo,8300000,2598224,-5701776,-0.6869609638554217,False,4,['Drama'],5.6
915,Limitless,27000000,155564919,128564919,4.761663666666666,True,3,['Documentary'],3.9
429,Lincoln,65000000,273346281,208346281,3.2053274,True,11,"['Biography', 'Drama', 'History']",7.4
1356,Lion,12000000,149570720,137570720,11.464226666666667,True,11,"['Action', 'Drama', 'Romance']",3.6
1130,Little Boy,20000000,17769299,-2230701,-0.11153505,False,4,"['Drama', 'History', 'War']",7.4
275,Little Fockers,100000000,310650574,210650574,2.10650574,True,12,"['Comedy', 'Romance']",5.5
1245,Little Women,15000000,50003303,35003303,2.3335535333333333,True,9,"['Drama', 'Family']",4.6
445,Live by Night,65000000,21774432,-43225568,-0.6650087384615384,False,12,"['Action', 'Crime', 'Drama']",6.4
1921,Locke,2000000,2088390,88390,0.044195,False,4,['Drama'],7.1
2139,Locker 13,300000,3496,-296504,-0.9883466666666667,False,3,['Thriller'],4.7
1114,Lockout,20000000,33943049,13943049,0.69715245,False,4,"['Action', 'Sci-Fi', 'Thriller']",6.1
215,Logan,127000000,615461394,488461394,3.846152708661417,True,3,"['Comedy', 'Drama', 'Family']",6.2
889,Logan Lucky,29000000,44264271,15264271,0.5263541724137931,False,8,"['Comedy', 'Crime', 'Drama']",7.0
1571,London Fields,8000000,433732,-7566268,-0.9457835,False,10,"['Crime', 'Mystery', 'Thriller']",4.3
461,London Has Fallen,60000000,195194085,135194085,2.25323475,True,3,"['Action', 'Thriller']",5.9
635,Lone Survivor,40000000,149804632,109804632,2.7451158,True,12,"['Action', 'Biography', 'Drama']",7.5
670,Long Shot,40000000,43711031,3711031,0.092775775,False,9,"['Comedy', 'Romance']",7.2
814,Looper,30000000,170466405,140466405,4.6822135,True,9,"['Action', 'Crime', 'Drama']",7.4
1930,Lost River,2000000,2009644,9644,0.004822,False,4,"['Drama', 'Fantasy', 'Mystery']",5.8
1215,Lottery Ticket,17000000,24719879,7719879,0.4541105294117647,False,8,['Comedy'],5.0
1003,Love Ranch,25000000,146149,-24853851,-0.99415404,False,6,"['Biography', 'Comedy', 'Drama']",5.6
2125,Love in the Time of Monsters,500000,0,-500000,-1.0,False,3,"['Comedy', 'Horror']",5.5
1179,Love the Coopers,18000000,42227490,24227490,1.3459716666666666,False,11,"['Comedy', 'Fantasy', 'Romance']",5.8
1419,"Love, Simon",10000000,65520633,55520633,5.5520633,True,3,"['Comedy', 'Drama', 'Romance']",7.6
1410,Lovesick,10100000,10143618,43618,0.004318613861386138,False,4,"['Comedy', 'Fantasy', 'Romance']",5.0
1532,Loving,9000000,12898064,3898064,0.43311822222222224,False,11,"['Drama', 'Romance']",7.1
2072,Lowriders,916000,6188421,5272421,5.755918122270742,True,5,"['Adventure', 'Crime', 'Drama']",5.7
1950,Lucky Dog,2000000,0,-2000000,-1.0,False,1,"['Comedy', 'Crime']",4.0
634,Lucy,40000000,457507776,417507776,10.4376944,True,7,['Documentary'],7.0
1462,MacGruber,10000000,8629895,-1370105,-0.1370105,False,5,"['Action', 'Comedy', 'Romance']",5.5
1343,Machete,12500000,46370970,33870970,2.7096776,True,9,"['Action', 'Crime', 'Thriller']",6.6
1129,Machete Kills,20000000,18273009,-1726991,-0.08634955,False,10,"['Action', 'Crime', 'Sci-Fi']",5.6
877,Machine Gun Preacher,30000000,3721988,-26278012,-0.8759337333333334,False,9,"['Action', 'Biography', 'Crime']",6.8
145,Mad Max: Fury Road,150000000,370098020,220098020,1.4673201333333334,False,5,"['Action', 'Adventure', 'Sci-Fi']",8.1
155,Madagascar 3: Europe's Most Wanted,145000000,746921271,601921271,4.151181179310345,True,6,"['Adventure', 'Animation', 'Comedy']",6.8
1569,Made in Dagenham,8000000,15644196,7644196,0.9555245,False,11,"['Biography', 'Comedy', 'Drama']",7.2
944,Madea's Big Happy Family,25000000,54160818,29160818,1.16643272,False,4,"['Comedy', 'Drama']",4.7
1748,Maggie,4500000,1027760,-3472240,-0.7716088888888889,False,5,['Drama'],6.4
1587,Magic Mike,7000000,170549753,163549753,23.364250428571427,True,6,"['Comedy', 'Drama']",6.1
1293,Magic Mike XXL,14500000,123660597,109160597,7.528317034482758,True,7,"['Comedy', 'Drama', 'Music']",5.6
75,Maleficent,180000000,758536735,578536735,3.2140929722222222,True,5,"['Action', 'Adventure', 'Family']",7.0
1239,Mama,15000000,148095566,133095566,8.873037733333334,True,1,['Drama'],4.5
22,Man of Steel,225000000,667999518,442999518,1.9688867466666666,False,6,"['Action', 'Adventure', 'Sci-Fi']",7.1
626,Man on a Ledge,42000000,49621440,7621440,0.18146285714285715,False,1,"['Action', 'Adventure', 'Crime']",6.6
1541,Manchester by the Sea,8500000,77733867,69233867,8.145160823529412,True,11,['Drama'],7.8
769,Mandela: Long Walk to Freedom,35000000,29890402,-5109598,-0.1459885142857143,False,12,"['Biography', 'Drama', 'History']",7.1
1633,Mandy,6000000,1427656,-4572344,-0.7620573333333334,False,1,"['Drama', 'Thriller']",4.1
1778,Manglehorn,4000000,797439,-3202561,-0.80064025,False,6,['Drama'],5.6
2135,Maniac,350000,10000000,9650000,27.571428571428573,True,10,"['Action', 'Horror', 'Thriller']",4.8
1307,Margaret,14000000,623292,-13376708,-0.9554791428571429,False,9,['Drama'],6.5
1810,Margin Call,3400000,20433227,17033227,5.009772647058823,True,10,"['Drama', 'Thriller']",7.1
554,Marmaduke,50000000,89895930,39895930,0.7979186,False,6,"['Comedy', 'Family']",4.2
154,Mars Needs Moms,150000000,39549758,-110450242,-0.7363349466666667,False,3,"['Adventure', 'Animation', 'Family']",5.4
1373,Marshall,12000000,10116816,-1883184,-0.156932,False,10,"['Biography', 'Crime', 'Drama']",7.2
2035,Martha Marcy May Marlene,1000000,5438911,4438911,4.438911,True,10,"['Drama', 'Mystery', 'Thriller']",6.9
202,Mary Poppins Returns,130000000,341528518,211528518,1.6271424461538462,False,12,"['Comedy', 'Family', 'Fantasy']",6.9
970,Mary Queen of Scots,25000000,46734733,21734733,0.86938932,False,12,"['Biography', 'Drama', 'History']",5.5
1085,Max,20000000,43658157,23658157,1.18290785,False,6,['Comedy'],5.1
1478,Max Steel,10000000,4563080,-5436920,-0.543692,False,10,"['Action', 'Adventure', 'Family']",4.6
453,Maze Runner: The Scorch Trials,61000000,310566162,249566162,4.09124855737705,True,9,"['Action', 'Sci-Fi', 'Thriller']",6.3
1212,"McFarland, USA",17000000,45707924,28707924,1.688701411764706,False,2,"['Biography', 'Drama', 'Sport']",7.4
1077,Me Before You,20000000,208265198,188265198,9.4132599,True,6,"['Drama', 'Romance']",7.4
1559,Me and Earl and the Dying Girl,8000000,9266180,1266180,0.1582725,False,6,"['Comedy', 'Drama', 'Romance']",7.8
676,Mechanic: Resurrection,40000000,109738840,69738840,1.743471,False,8,"['Action', 'Adventure', 'Thriller']",5.7
1922,Meek's Cutoff,2000000,1869928,-130072,-0.065036,False,10,"['Drama', 'Western']",6.6
2076,Meet the Blacks,900000,9097072,8197072,9.107857777777777,True,4,"['Comedy', 'Horror']",5.9
1910,Meet the Mormons,2000000,6049171,4049171,2.0245855,True,10,['Documentary'],6.9
204,Megamind,130000000,321887208,191887208,1.4760554461538462,False,11,"['Action', 'Animation', 'Comedy']",7.3
1521,Melancholia,9400000,21817298,12417298,1.3209891489361703,False,11,"['Drama', 'Mystery', 'Romance']",3.3
27,Men in Black 3,215000000,654213485,439213485,2.042853418604651,True,5,"['Action', 'Adventure', 'Comedy']",6.8
1546,Middle School: The Worst Years of My Life,8500000,23311293,14811293,1.7425050588235294,False,10,"['Comedy', 'Family']",6.1
2170,Middle of Nowhere,200000,236806,36806,0.18403,False,1,['Drama'],6.4
1191,Midnight Special,18000000,7680250,-10319750,-0.5733194444444445,False,3,"['Action', 'Drama', 'Mystery']",6.6
818,Midnight in Paris,30000000,162502774,132502774,4.416759133333334,True,5,"['Comedy', 'Fantasy', 'Romance']",7.7
784,Mike and Dave Need Wedding Dates,33000000,75898100,42898100,1.2999424242424242,False,7,"['Adventure', 'Comedy', 'Romance']",6.0
741,Mile 22,35000000,66295121,31295121,0.8941463142857143,False,8,"['Action', 'Adventure', 'Thriller']",6.1
1100,Milk,20000000,57293371,37293371,1.86466855,False,3,"['Documentary', 'Family']",7.2
954,Million Dollar Arm,25000000,39217912,14217912,0.56871648,False,5,"['Biography', 'Drama', 'Sport']",7.0
394,Minions,74000000,1160336173,1086336173,14.680218554054054,True,7,"['Adventure', 'Animation', 'Comedy']",6.4
1319,Miracles from Heaven,13000000,73798736,60798736,4.6768258461538466,True,3,"['Biography', 'Drama', 'Family']",7.1
342,Mirror Mirror,85000000,173613482,88613482,1.0425115529411764,False,3,"['Adventure', 'Comedy', 'Drama']",5.6
1408,Misconduct,11000000,2352511,-8647489,-0.7861353636363636,False,2,"['Crime', 'Drama', 'Mystery']",5.3
1267,Miss Bala,15000000,15362298,362298,0.0241532,False,10,"['Action', 'Crime', 'Drama']",5.5
1659,Miss Julie,5500000,863895,-4636105,-0.8429281818181819,False,10,"['Drama', 'Romance']",4.1
1192,Miss Sloane,18000000,7719630,-10280370,-0.5711316666666667,False,11,"['Drama', 'Thriller']",7.5
138,Moana,150000000,637517365,487517365,3.2501157666666667,True,11,"['Adventure', 'Animation', 'Comedy']",7.6
1064,Molly,21000000,17396,-20982604,-0.9991716190476191,False,9,"['Action', 'Sci-Fi']",4.6
1736,Mommy,4900000,17536004,12636004,2.5787763265306123,True,8,['Drama'],8.1
916,Money Monster,27000000,93466095,66466095,2.461707222222222,True,5,"['Crime', 'Drama', 'Thriller']",6.5
543,Moneyball,50000000,111300835,61300835,1.2260167,False,9,"['Biography', 'Drama', 'Sport']",7.6
1680,Monster,5000000,64240813,59240813,11.8481626,True,1,"['Action', 'Adventure', 'Comedy']",4.8
232,Monster Trucks,125000000,61642798,-63357202,-0.506857616,False,1,"['Action', 'Adventure', 'Comedy']",5.7
2106,Monsters,500000,5639730,5139730,10.27946,True,10,['Horror'],4.0
48,Monsters University,200000000,743588329,543588329,2.717941645,True,6,"['Adventure', 'Animation', 'Comedy']",7.3
1107,Monte Carlo,20000000,39686769,19686769,0.98433845,False,7,"['Adventure', 'Comedy', 'Family']",5.8
1979,Moonlight,1500000,65245512,63745512,42.497008,True,10,['Drama'],7.4
1223,Moonrise Kingdom,16000000,68848446,52848446,3.303027875,True,5,"['Adventure', 'Comedy', 'Drama']",7.8
1561,Morgan,8000000,7298786,-701214,-0.08765175,False,1,"['Drama', 'Romance']",6.8
669,Morning Glory,40000000,59795070,19795070,0.49487675,False,11,"['Comedy', 'Drama', 'Romance']",6.5
294,Mortal Engines,100000000,85287417,-14712583,-0.14712583,False,12,"['Action', 'Adventure', 'Fantasy']",6.1
484,Mortdecai,60000000,30396134,-29603866,-0.4933977666666667,False,1,"['Action', 'Comedy', 'Crime']",5.5
1460,Movie 43,10000000,31164747,21164747,2.1164747,True,1,['Comedy'],4.3
158,Mr. Peabody & Sherman,145000000,269806430,124806430,0.860734,False,3,"['Adventure', 'Animation', 'Comedy']",6.8
1304,Mr. Turner,14000000,25187026,11187026,0.7990732857142857,False,12,"['Biography', 'Drama', 'History']",6.8
1555,Much Ado About Nothing,8000000,22549338,14549338,1.81866725,False,1,"['Comedy', 'Drama', 'Romance']",4.5
1436,Mud,10000000,31556959,21556959,2.1556959,True,5,['Drama'],6.5
508,Muppets Most Wanted,55000000,79312301,24312301,0.44204183636363636,False,3,"['Adventure', 'Comedy', 'Crime']",6.4
501,Murder on the Orient Express,55000000,345922730,290922730,5.289504181818182,True,11,"['Crime', 'Drama', 'Mystery']",6.5
1998,Mustang,1400000,5552584,4152584,2.9661314285714284,True,11,['Drama'],7.6
586,My Best Friend's Wedding,46000000,298923419,252923419,5.4983351956521735,True,8,"['Comedy', 'Romance']",5.0
1171,My Big Fat Greek Wedding 2,18000000,92096558,74096558,4.116475444444444,True,3,"['Comedy', 'Romance']",6.0
2000,My Girlfriend's Boyfriend,1400000,0,-1400000,-1.0,False,4,"['Comedy', 'Romance']",5.8
2062,My Last Day Without You,1000000,0,-1000000,-1.0,False,6,"['Comedy', 'Drama', 'Romance']",5.7
986,My Soul to Take,25000000,16727470,-8272530,-0.3309012,False,10,"['Horror', 'Mystery', 'Thriller']",4.8
1448,My Week with Marilyn,10000000,34240572,24240572,2.4240572,True,11,"['Biography', 'Drama']",7.0
1975,N-Secure,1600000,2595644,995644,0.6222775,False,10,"['Crime', 'Drama', 'Thriller']",3.6
1368,Nebraska,12000000,24761360,12761360,1.0634466666666667,False,11,"['Adventure', 'Comedy', 'Drama']",7.7
427,Need for Speed,66000000,194169619,128169619,1.9419639242424243,False,3,"['Action', 'Crime', 'Thriller']",6.5
1168,Neighbors,18000000,270944428,252944428,14.052468222222222,True,5,"['Comedy', 'Drama']",7.6
732,Neighbors 2: Sorority Rising,35000000,108757621,73757621,2.1073606,True,5,['Comedy'],5.7
1087,Nerve,20000000,70652284,50652284,2.5326142,True,12,"['Documentary', 'History']",6.2
1279,Never Let Me Go,15000000,11173718,-3826282,-0.25508546666666665,False,9,"['Drama', 'Romance', 'Sci-Fi']",7.1
2225,Newlyweds,9000,4584,-4416,-0.49066666666666664,False,12,"['Comedy', 'Drama']",6.4
886,Night School,29000000,103008792,74008792,2.5520273103448274,True,4,['Documentary'],7.2
216,Night at the Museum: Secret of the Tomb,127000000,353756621,226756621,1.7854852047244094,False,12,"['Adventure', 'Comedy', 'Family']",6.2
1754,Night of the Living Dead,4200000,5835247,1635247,0.38934452380952383,False,10,['Horror'],5.3
1543,Nightcrawler,8500000,50334418,41834418,4.921696235294117,True,10,"['Crime', 'Drama', 'Thriller']",7.9
1941,Nine Dead,2000000,0,-2000000,-1.0,False,3,"['Crime', 'Drama', 'Horror']",5.5
1686,No Escape,5000000,42844516,37844516,7.5689032,True,8,"['Action', 'Thriller']",6.8
1315,No Good Deed,13200000,54323210,41123210,3.115394696969697,True,9,"['Action', 'Crime', 'Drama']",5.6
2036,No Man's Land,1000000,2684207,1684207,1.684207,False,1,['Documentary'],7.7
941,No Strings Attached,25000000,149228078,124228078,4.96912312,True,1,"['Comedy', 'Romance']",6.2
209,Noah,130000000,352831065,222831065,1.7140851153846153,False,3,"['Drama', 'Thriller']",6.5
1032,Nocturnal Animals,22500000,32398681,9898681,0.43994137777777775,False,11,"['Drama', 'Thriller']",7.5
536,Non-Stop,50000000,222383055,172383055,3.4476611,True,11,"['Action', 'Mystery', 'Thriller']",7.0
1183,Norm of the North,18000000,30535660,12535660,0.6964255555555555,False,1,"['Adventure', 'Animation', 'Comedy']",3.6
2082,Not Cool,800000,35688,-764312,-0.95539,False,9,"['Comedy', 'Drama', 'Romance']",4.5
1785,Nothing,4000000,63180,-3936820,-0.984205,False,2,['Drama'],7.4
2150,November,250000,191862,-58138,-0.232552,False,2,"['Drama', 'Fantasy', 'Horror']",7.2
382,Now You See Me,75000000,342769200,267769200,3.570256,True,5,"['Drama', 'Horror', 'Thriller']",7.0
326,Now You See Me 2,90000000,328325007,238325007,2.648055633333333,True,6,"['Action', 'Adventure', 'Comedy']",6.5
237,Oblivion,120000000,287916633,167916633,1.399305275,False,4,['Thriller'],8.0
2034,Obvious Child,1000000,3324070,2324070,2.32407,True,6,"['Comedy', 'Drama', 'Romance']",6.8
2032,October Baby,1000000,5391992,4391992,4.391992,True,10,['Drama'],6.8
1683,Oculus,5000000,44115496,39115496,7.8230992,True,4,"['Horror', 'Mystery']",6.5
596,Office Christmas Party,45000000,91323299,46323299,1.0294066444444445,False,12,['Comedy'],5.8
1844,Oldboy,3000000,6239723,3239723,1.0799076666666667,False,11,"['Action', 'Drama', 'Mystery']",5.8
397,Olympus Has Fallen,70000000,172878928,102878928,1.4696989714285715,False,3,"['Action', 'Thriller']",6.5
1104,On the Basis of Sex,20000000,38073377,18073377,0.90366885,False,12,"['Biography', 'Drama']",6.9
1002,On the Road,25000000,9313302,-15686698,-0.62746792,False,12,['Drama'],6.0
1269,One Day,15000000,59168692,44168692,2.9445794666666667,True,8,['Family'],6.2
622,One for the Money,42000000,36197221,-5802779,-0.13816140476190475,False,1,"['Action', 'Comedy', 'Crime']",5.3
1739,Only God Forgives,4800000,4494560,-305440,-0.06363333333333333,False,7,"['Crime', 'Drama']",5.7
699,Only the Brave,38000000,24555177,-13444823,-0.3538111315789474,False,10,"['Action', 'Biography', 'Drama']",7.7
1858,Open Road,3000000,47469,-2952531,-0.984177,False,5,"['Action', 'Drama', 'Thriller']",5.5
2193,Open Secret,100000,0,-100000,-1.0,False,11,['Documentary'],6.5
1678,Ouija,5000000,103300632,98300632,19.6601264,True,10,"['Horror', 'Mystery', 'Thriller']",4.5
1525,Ouija: Origin of Evil,9000000,81831866,72831866,8.092429555555556,True,10,"['Drama', 'Horror', 'Mystery']",6.1
1299,Our Family Wedding,14000000,21410546,7410546,0.5293247142857143,False,3,"['Comedy', 'Romance']",4.9
1689,Our Idiot Brother,5000000,25861249,20861249,4.1722498,True,8,"['Comedy', 'Drama']",6.4
1743,Out of the Blue,4600000,731767,-3868233,-0.8409202173913044,False,10,"['Comedy', 'Drama']",6.2
1976,Out of the Dark,1600000,419428,-1180572,-0.7378575,False,2,"['Horror', 'Thriller']",4.8
1048,Out of the Furnace,22000000,15434375,-6565625,-0.2984375,False,12,"['Crime', 'Drama', 'Thriller']",6.8
1358,Overboard,12000000,85369830,73369830,6.1141525,True,5,"['Comedy', 'Romance']",5.9
49,Oz the Great and Powerful,200000000,490359051,290359051,1.451795255,False,3,"['Adventure', 'Family', 'Fantasy']",6.3
64,Pacific Rim,190000000,411002906,221002906,1.1631731894736843,False,7,"['Action', 'Adventure', 'Sci-Fi']",6.9
131,Pacific Rim: Uprising,155000000,290930148,135930148,0.8769686967741935,False,3,"['Action', 'Adventure', 'Sci-Fi']",5.6
506,Paddington,55000000,258789097,203789097,3.705256309090909,True,1,"['Adventure', 'Comedy', 'Family']",7.2
920,Pain & Gain,26000000,81275291,55275291,2.125972730769231,True,4,"['Action', 'Comedy', 'Crime']",6.4
2040,Palo Alto,1000000,1156309,156309,0.156309,False,5,['Drama'],6.2
153,Pan,150000000,151525973,1525973,0.010173153333333334,False,10,"['Adventure', 'Comedy', 'Family']",5.8
1362,Paper Towns,12000000,85450484,73450484,6.120873666666666,True,7,"['Comedy', 'Drama', 'Mystery']",6.3
466,ParaNorman,60000000,108119662,48119662,0.8019943666666667,False,8,"['Adventure', 'Animation', 'Comedy']",7.0
683,Paranoia,40000000,16340767,-23659233,-0.591480825,False,5,['Thriller'],5.3
1821,Paranormal Activity 2,3000000,177512032,174512032,58.17067733333333,True,10,['Horror'],5.7
1671,Paranormal Activity 3,5000000,207039844,202039844,40.4079688,True,10,"['Horror', 'Mystery', 'Thriller']",5.8
1677,Paranormal Activity 4,5000000,142817992,137817992,27.5635984,True,10,"['Horror', 'Mystery', 'Thriller']",4.6
1442,Paranormal Activity: The Ghost Dimension,10000000,77959374,67959374,6.7959374,True,10,"['Horror', 'Mystery', 'Thriller']",4.6
1682,Paranormal Activity: The Marked Ones,5000000,90904854,85904854,17.1809708,True,1,"['Horror', 'Mystery', 'Thriller']",5.0
940,Parental Guidance,25000000,120832383,95832383,3.83329532,True,12,"['Comedy', 'Family']",6.1
762,Parker,35000000,48543388,13543388,0.38695394285714285,False,1,"['Action', 'Crime', 'Thriller']",6.2
1496,Parkland,10000000,1616353,-8383647,-0.8383647,False,10,"['Drama', 'History', 'Mystery']",6.4
257,Passengers,110000000,302239672,192239672,1.7476333818181817,False,12,"['Drama', 'Romance', 'Sci-Fi']",7.0
1719,Paterson,5000000,10727536,5727536,1.1455072,False,12,"['Comedy', 'Drama', 'Romance']",7.4
667,Patriots Day,40000000,52837989,12837989,0.320949725,False,12,"['Action', 'Crime', 'Drama']",7.4
2039,Patti Cake$,1000000,1471090,471090,0.47109,False,8,"['Drama', 'Music']",6.7
662,Paul,40000000,101162106,61162106,1.52905265,False,3,['Drama'],4.8
692,Paul Blart: Mall Cop 2,38000000,107650646,69650646,1.8329117368421053,False,4,"['Action', 'Comedy', 'Crime']",4.4
1696,"Paul, Apostle of Christ",5000000,25529498,20529498,4.1058996,True,3,"['Adventure', 'Biography', 'Drama']",6.7
541,Payback,50000000,161626121,111626121,2.23252242,True,3,"['Action', 'Crime', 'Drama']",5.5
1404,Peeples,11000000,9307166,-1692834,-0.153894,False,5,"['Comedy', 'Romance']",5.3
177,Penguins of Madagascar,132000000,366942531,234942531,1.779867659090909,False,11,"['Adventure', 'Animation', 'Comedy']",6.7
1227,People Like Us,16000000,12617472,-3382528,-0.211408,False,6,['Drama'],6.4
955,Peppermint,25000000,51800758,26800758,1.07203032,False,9,"['Action', 'Crime', 'Drama']",6.5
304,Percy Jackson & the Olympians: The Lightning Thief,95000000,223050874,128050874,1.3479039368421053,False,2,"['Adventure', 'Family', 'Fantasy']",5.9
325,Percy Jackson: Sea of Monsters,90000000,200859554,110859554,1.2317728222222222,False,8,"['Adventure', 'Family', 'Fantasy']",5.8
2172,Perfect Cowboy,200000,0,-200000,-1.0,False,7,['Drama'],5.9
533,Peter Rabbit,50000000,347136477,297136477,5.94272954,True,2,"['Adventure', 'Animation', 'Comedy']",6.6
1196,Phantom,18000000,1199510,-16800490,-0.9333605555555555,False,3,"['Crime', 'Horror', 'Thriller']",8.2
1359,Philomena,12000000,98963392,86963392,7.246949333333333,True,11,"['Biography', 'Comedy', 'Drama']",7.6
2010,"Pink Ribbons, Inc.",1200000,26608,-1173392,-0.9778266666666666,False,4,['Documentary'],7.3
1016,Piranha 3D,24000000,83660160,59660160,2.48584,True,8,"['Comedy', 'Horror']",5.4
19,Pirates of the Caribbean: Dead Men Tell No Tales,230000000,788241137,558241137,2.4271353782608696,True,5,"['Action', 'Adventure', 'Fantasy']",6.6
1,Pirates of the Caribbean: On Stranger Tides,410600000,1045663875,635063875,1.5466728567949342,False,5,"['Action', 'Adventure', 'Fantasy']",6.6
1210,Pitch Perfect,17000000,116044347,99044347,5.826138058823529,True,9,"['Comedy', 'Music', 'Romance']",7.2
885,Pitch Perfect 2,29000000,287625468,258625468,8.918119586206897,True,5,"['Comedy', 'Music']",6.4
589,Pitch Perfect 3,45000000,185736412,140736412,3.1274758222222223,True,12,"['Comedy', 'Music']",5.8
323,Pixels,90000000,244041804,154041804,1.7115756,False,4,"['Action', 'Comedy']",4.6
1509,Plastic,10000000,575371,-9424629,-0.9424629,False,10,['Thriller'],2.5
773,Playing for Keeps,35000000,2000000,-33000000,-0.9428571428571428,False,12,"['Comedy', 'Romance', 'Sport']",5.7
1836,Please Give,3000000,4570178,1570178,0.5233926666666666,False,1,"['Comedy', 'Drama']",6.6
1935,Plush,2000000,28864,-1971136,-0.985568,False,10,"['Drama', 'Music', 'Thriller']",5.4
1863,Point Blank,3000000,0,-3000000,-1.0,False,7,"['Crime', 'Documentary', 'History']",8.2
288,Point Break,100000000,126704591,26704591,0.26704591,False,12,"['Action', 'Crime', 'Sport']",5.3
1540,Polisse,8900000,22744132,13844132,1.5555204494382022,False,11,"['Crime', 'Drama']",7.3
734,Poltergeist,35000000,95713069,60713069,1.7346591142857142,False,5,"['Horror', 'Thriller']",4.9
370,Pompeii,80000000,108469033,28469033,0.3558629125,False,2,"['Action', 'Adventure', 'Drama']",5.5
1122,Popstar: Never Stop Never Stopping,20000000,9537120,-10462880,-0.523144,False,6,"['Comedy', 'Music']",6.7
1584,Pound of Flesh,7500000,0,-7500000,-1.0,False,5,['Drama'],7.5
238,Power Rangers,120000000,142531552,22531552,0.18776293333333333,False,3,"['Action', 'Adventure', 'Sci-Fi']",6.0
655,Predators,40000000,127234389,87234389,2.180859725,True,7,"['Action', 'Adventure', 'Sci-Fi']",6.4
758,Premium Rush,35000000,31393201,-3606799,-0.1030514,False,8,"['Action', 'Crime', 'Thriller']",6.5
912,Pride and Prejudice and Zombies,28000000,16638300,-11361700,-0.405775,False,2,"['Action', 'Comedy', 'Horror']",5.8
482,Priest,60000000,84154026,24154026,0.4025671,False,5,"['Action', 'Adventure', 'Fantasy']",5.7
587,Prisoners,46000000,113402302,67402302,1.4652674347826087,False,9,"['Crime', 'Drama', 'Mystery']",8.1
1366,Project Almanac,12000000,32909437,20909437,1.7424530833333334,False,1,"['Drama', 'Mystery', 'Sci-Fi']",6.4
1353,Project X,12000000,103028188,91028188,7.585682333333334,True,11,['Comedy'],6.7
1558,Prom,8000000,10763183,2763183,0.345397875,False,4,"['Comedy', 'Drama', 'Family']",5.4
227,Prometheus,125000000,402448265,277448265,2.21958612,True,6,"['Adventure', 'Mystery', 'Sci-Fi']",7.0
1273,Promised Land,15000000,12394562,-2605438,-0.17369586666666667,False,12,['Drama'],6.6
859,Proud Mary,30000000,21709539,-8290461,-0.2763487,False,1,"['Action', 'Crime', 'Drama']",4.9
1929,Pump,2000000,72277,-1927723,-0.9638615,False,9,['Documentary'],7.7
203,Puss in Boots,130000000,554987477,424987477,3.2691344384615384,True,10,"['Action', 'Adventure', 'Animation']",6.6
1402,Quartet,11000000,56178935,45178935,4.107175909090909,True,1,"['Comedy', 'Drama']",6.8
2197,Queen Crab,75000,0,-75000,-1.0,False,9,"['Action', 'Sci-Fi', 'Thriller']",4.2
1272,Queen of Katwe,15000000,10055481,-4944519,-0.3296346,False,9,"['Biography', 'Drama', 'Sport']",7.4
720,Queen of the Desert,36000000,1578543,-34421457,-0.9561515833333334,False,3,"['Adventure', 'Biography', 'Drama']",5.7
213,R.I.P.D.,130000000,79076678,-50923322,-0.39171786153846155,False,7,"['Action', 'Adventure', 'Comedy']",5.6
349,RED 2,84000000,141507355,57507355,0.6846113690476191,False,7,"['Action', 'Comedy', 'Crime']",6.6
1716,Rabbit Hole,5000000,6205034,1205034,0.2410068,False,12,['Drama'],7.0
1693,Race,5000000,23745772,18745772,3.7491544,True,2,['Drama'],3.9
1260,Ramona and Beezus,15000000,27469621,12469621,0.8313080666666667,False,7,"['Adventure', 'Comedy', 'Family']",6.6
235,Rampage,120000000,428056280,308056280,2.5671356666666667,True,4,"['Action', 'Adventure', 'Sci-Fi']",6.1
171,Rango,135000000,245724600,110724600,0.8201822222222223,False,3,"['Adventure', 'Animation', 'Comedy']",7.2
1379,Ravenous,12000000,2062406,-9937594,-0.8281328333333333,False,9,"['Drama', 'Horror', 'Sci-Fi']",5.9
2213,Raymond Did It,40000,3632,-36368,-0.9092,False,3,['Horror'],3.3
1520,Re-Kill,9500000,0,-9500000,-1.0,False,10,"['Action', 'Horror']",5.0
1733,Reach Me,5000000,0,-5000000,-1.0,False,3,"['Comedy', 'Crime', 'Drama']",4.9
146,Ready Player One,150000000,579290136,429290136,2.86193424,True,3,"['Action', 'Adventure', 'Sci-Fi']",7.5
1007,Reagan,25000000,0,-25000000,-1.0,False,2,"['Biography', 'Documentary']",7.4
260,Real Steel,110000000,263880341,153880341,1.398912190909091,False,10,"['Action', 'Drama', 'Family']",7.1
602,Rebound,45000000,17492014,-27507986,-0.6112885777777778,False,6,"['Horror', 'Mystery', 'Thriller']",4.2
457,Red,60000000,196439693,136439693,2.273994883333333,True,1,['Drama'],8.4
438,Red Dawn,65000000,48164150,-16835850,-0.2590130769230769,False,11,"['Action', 'Sci-Fi', 'Thriller']",5.4
919,Red Eye,26000000,96666486,70666486,2.717941769230769,True,10,['Horror'],3.3
1205,Red Lights,17700000,14518884,-3181116,-0.17972406779661018,False,7,"['Drama', 'Fantasy', 'Horror']",6.2
620,Red Riding Hood,42000000,91678442,49678442,1.1828200476190476,False,3,"['Fantasy', 'Horror', 'Mystery']",5.5
1828,Red River,3000000,9012000,6012000,2.004,True,5,['Horror'],2.3
1005,Red Sky,25000000,91116,-24908884,-0.99635536,False,3,['Thriller'],4.9
417,Red Sparrow,69000000,145951861,76951861,1.1152443623188406,False,3,"['Action', 'Drama', 'Thriller']",6.6
1769,Red State,4000000,1983596,-2016404,-0.504101,False,9,"['Action', 'Crime', 'Horror']",6.2
492,Red Tails,58000000,50365498,-7634502,-0.1316293448275862,False,1,"['Action', 'Adventure', 'Drama']",5.9
1031,Redemption,23000000,13593473,-9406527,-0.4089794347826087,False,10,"['Drama', 'Mystery', 'Thriller']",8.4
1892,Redemption Road,2300000,29384,-2270616,-0.9872243478260869,False,8,['Drama'],5.8
1143,Regression,20000000,15824374,-4175626,-0.2087813,False,2,"['Crime', 'Horror', 'Mystery']",5.7
1308,Reign of Assassins,14000000,11354230,-2645770,-0.18898357142857142,False,9,"['Action', 'Adventure']",6.9
1226,Remember Me,16000000,56506120,40506120,2.5316325,True,3,['Comedy'],5.2
801,Repo Men,32000000,18195238,-13804762,-0.4313988125,False,3,"['Action', 'Crime', 'Sci-Fi']",6.3
494,Resident Evil: Afterlife,57500000,295874190,238374190,4.145638086956522,True,9,"['Action', 'Adventure', 'Horror']",5.9
441,Resident Evil: Retribution,65000000,240647629,175647629,2.7022712153846156,True,9,"['Action', 'Horror', 'Sci-Fi']",5.4
673,Resident Evil: The Final Chapter,40000000,314101190,274101190,6.85252975,True,1,"['Action', 'Horror', 'Sci-Fi']",5.6
1572,Restless,8000000,2772511,-5227489,-0.653436125,False,9,['Drama'],8.4
1190,Restoration,18000000,4100000,-13900000,-0.7722222222222223,False,5,['Drama'],8.4
1178,Ricki and the Flash,18000000,41166033,23166033,1.2870018333333333,False,8,"['Comedy', 'Drama', 'Music']",5.9
696,Riddick,38000000,94763758,56763758,1.4937831052631578,False,9,"['Action', 'Adventure', 'Sci-Fi']",6.4
938,Ride Along,25000000,153733800,128733800,5.149352,True,1,['Action'],4.4
637,Ride Along 2,40000000,124827316,84827316,2.1206829,True,1,"['Action', 'Comedy', 'Crime']",5.9
961,Rings,25000000,82917283,57917283,2.31669132,True,2,"['Drama', 'Horror', 'Mystery']",4.5
319,Rio,90000000,487519809,397519809,4.416886766666667,True,4,['Drama'],2.6
205,Rio 2,130000000,492846291,362846291,2.7911253153846154,True,4,"['Adventure', 'Animation', 'Comedy']",6.3
159,Rise of the Guardians,145000000,306900902,161900902,1.1165579448275862,False,11,"['Action', 'Adventure', 'Animation']",7.3
313,Rise of the Planet of the Apes,93000000,470986200,377986200,4.064367741935484,True,8,"['Action', 'Drama', 'Sci-Fi']",7.6
1090,Risen,20000000,46255763,26255763,1.31278815,False,2,"['Biography', 'Drama']",5.3
1990,Road Hard,1500000,113169,-1386831,-0.924554,False,3,['Comedy'],6.1
2123,Roadside,500000,0,-500000,-1.0,False,3,"['Drama', 'Horror', 'Mystery']",3.8
30,Robin Hood,210000000,322459006,112459006,0.5355190761904762,False,1,['nan'],7.6
239,RoboCop,120000000,242981799,122981799,1.024848325,False,2,"['Action', 'Crime', 'Sci-Fi']",6.2
1877,Robot & Frank,2500000,4934356,2434356,0.9737424,False,8,"['Comedy', 'Crime', 'Drama']",7.1
483,Rock Dog,60000000,24148488,-35851512,-0.5975252,False,2,"['Adventure', 'Animation', 'Comedy']",5.9
408,Rock of Ages,70000000,61031932,-8968068,-0.12811525714285715,False,6,"['Comedy', 'Drama', 'Musical']",5.9
1277,Rock the Kasbah,15000000,3386153,-11613847,-0.7742564666666667,False,10,"['Comedy', 'Music', 'War']",5.5
1942,Rockaway,2000000,0,-2000000,-1.0,False,8,"['Adventure', 'Drama']",6.4
2128,Rodeo Girl,500000,0,-500000,-1.0,False,1,"['Adventure', 'Family']",5.8
38,Rogue One: A Star Wars Story,200000000,1049102856,849102856,4.24551428,True,12,"['Action', 'Adventure', 'Sci-Fi']",7.8
1046,"Roman J. Israel, Esq.",22000000,12967012,-9032988,-0.41059036363636364,False,11,"['Crime', 'Drama', 'Thriller']",6.4
1480,Romeo Is Bleeding,10000000,3275585,-6724415,-0.6724415,False,7,"['Biography', 'Documentary', 'Drama']",8.1
1328,Room,13000000,36262783,23262783,1.7894448461538461,False,10,"['Drama', 'Thriller']",8.2
1482,Rosewater,10000000,3185717,-6814283,-0.6814283,False,11,"['Biography', 'Drama']",6.6
2137,Rotor DR1,350000,0,-350000,-1.0,False,10,"['Family', 'Sci-Fi']",3.4
1108,Rough Night,20000000,46844357,26844357,1.34221785,False,6,"['Comedy', 'Crime', 'Thriller']",5.2
2110,Rubber,500000,680914,180914,0.361828,False,9,"['Comedy', 'Fantasy', 'Horror']",5.8
1725,Rudderless,5000000,567219,-4432781,-0.8865562,False,10,"['Comedy', 'Drama', 'Music']",7.5
560,Run All Night,50000000,66961644,16961644,0.33923288,False,3,"['Action', 'Drama', 'Thriller']",6.6
2208,"Run, Hide, Die",50000,0,-50000,-1.0,False,9,"['Horror', 'Thriller']",3.5
860,Runner Runner,30000000,60512680,30512680,1.0170893333333333,False,10,"['Crime', 'Thriller']",5.6
698,Rush,38000000,98230839,60230839,1.5850220789473684,False,9,"['Comedy', 'Romance']",7.9
2158,Rust,250000,0,-250000,-1.0,False,1,"['Horror', 'Thriller']",6.1
766,Sabotage,35000000,18376443,-16623557,-0.4749587714285714,False,3,"['Action', 'Crime', 'Drama']",5.7
787,Safe,33000000,41495213,8495213,0.25743069696969695,False,4,['Thriller'],3.8
897,Safe Haven,28000000,94050951,66050951,2.358962535714286,True,2,"['Drama', 'Romance', 'Thriller']",6.7
340,Safe House,85000000,208542162,123542162,1.4534372,False,2,"['Action', 'Adventure', 'Crime']",6.8
2087,Safety Not Guaranteed,750000,4422318,3672318,4.896424,True,6,"['Comedy', 'Drama', 'Romance']",7.0
206,Salt,130000000,290650494,160650494,1.2357730307692307,False,7,"['Action', 'Mystery', 'Thriller']",6.4
1658,Salvation Boulevard,5500000,28468,-5471532,-0.994824,False,7,"['Action', 'Comedy', 'Drama']",5.3
1613,Same Kind of Different as Me,6500000,6423605,-76395,-0.011753076923076923,False,10,"['Biography', 'Drama']",6.5
1767,Samsara,4000000,5966671,1966671,0.49166775,False,8,"['Documentary', 'Music']",8.5
254,San Andreas,110000000,456258539,346258539,3.1478049,True,5,"['Action', 'Adventure', 'Drama']",6.1
855,Sanctum,30000000,108957098,78957098,2.631903266666667,True,2,"['Adventure', 'Drama', 'Thriller']",5.9
1156,Sausage Party,19000000,141344255,122344255,6.439171315789474,True,8,"['Adventure', 'Animation', 'Comedy']",6.2
597,Savages,45000000,82513490,37513490,0.8336331111111112,False,7,"['Crime', 'Drama', 'Thriller']",6.5
727,Saving Mr. Banks,35000000,114962525,79962525,2.2846435714285716,True,12,"['Biography', 'Comedy', 'Drama']",7.5
1275,Scouts Guide to the Zombie Apocalypse,15000000,15554855,554855,0.03699033333333333,False,10,"['Action', 'Comedy', 'Horror']",6.3
661,Scream 4,40000000,95989590,55989590,1.39973975,False,4,"['Horror', 'Mystery']",6.2
1376,Screwed,12000000,6982680,-5017320,-0.41811,False,10,"['Comedy', 'Romance']",4.4
1705,Sea Rex 3D: Journey to a Prehistoric World,5000000,16515203,11515203,2.3030406,True,5,['Documentary'],6.9
675,Season of the Witch,40000000,91126600,51126600,1.278165,False,1,"['Action', 'Adventure', 'Fantasy']",5.4
1236,Second Act,15700000,63288854,47588854,3.0311371974522294,True,12,"['Comedy', 'Drama', 'Romance']",5.8
1111,Secret in Their Eyes,20000000,32608019,12608019,0.63040095,False,11,"['Crime', 'Drama', 'Mystery']",6.3
730,Secretariat,35000000,60376247,25376247,0.7250356285714286,False,10,"['Biography', 'Drama', 'Family']",7.2
1467,Seeking a Friend for the End of the World,10000000,11766959,1766959,0.1766959,False,6,"['Adventure', 'Comedy', 'Drama']",6.7
1080,Selma,20000000,66776576,46776576,2.3388288,True,12,"['Biography', 'Drama', 'History']",7.5
1311,Seven Psychopaths,13500000,33035736,19535736,1.4470915555555555,False,10,"['Comedy', 'Crime']",7.2
310,Seventh Son,95000000,108874967,13874967,0.14605228421052632,False,2,"['Action', 'Adventure', 'Fantasy']",5.5
660,Sex Tape,40000000,126069509,86069509,2.151737725,True,7,"['Comedy', 'Romance']",5.1
303,Sex and the City 2,95000000,294680778,199680778,2.1019029263157893,True,5,"['Comedy', 'Drama', 'Romance']",4.4
998,Sgt. Stubby: An American Hero,25000000,3645957,-21354043,-0.85416172,False,4,"['Adventure', 'Animation', 'Family']",6.9
1615,Shame,6500000,20412841,13912841,2.1404370769230767,True,12,['Drama'],6.4
572,Shanghai,50000000,15505922,-34494078,-0.68988156,False,10,"['Crime', 'Drama', 'Mystery']",6.4
1955,Shark Lake,2000000,0,-2000000,-1.0,False,10,"['Action', 'Adventure', 'Crime']",3.5
966,Shark Night 3D,25000000,18877153,-6122847,-0.24491388,False,9,"['Horror', 'Thriller']",4.0
1097,She's Out of My League,20000000,48680977,28680977,1.43404885,False,3,"['Comedy', 'Romance']",6.4
486,Sherlock Gnomes,59000000,87527651,28527651,0.48351950847457625,False,3,"['Adventure', 'Animation', 'Comedy']",5.1
318,Sherlock Holmes,90000000,498438212,408438212,4.538202355555556,True,1,['Adventure'],5.4
221,Sherlock Holmes: A Game of Shadows,125000000,535663443,410663443,3.285307544,True,12,"['Action', 'Adventure', 'Crime']",7.5
104,Shrek Forever After,165000000,756244673,591244673,3.5833010484848486,True,5,"['Adventure', 'Animation', 'Comedy']",6.3
1468,Shut In,10000000,11360665,1360665,0.1360665,False,11,"['Drama', 'Mystery', 'Thriller']",4.7
1553,Shutter,8000000,47782426,39782426,4.97280325,True,6,"['Drama', 'Family', 'Thriller']",7.2
357,Shutter Island,80000000,299461782,219461782,2.743272275,True,2,"['Mystery', 'Thriller']",8.1
825,Sicario,30000000,84393749,54393749,1.8131249666666667,False,9,"['Action', 'Crime', 'Drama']",7.6
733,Sicario: Day of the Soldado,35000000,75885196,40885196,1.168148457142857,False,6,"['Action', 'Crime', 'Drama']",7.1
847,Side Effects,30000000,66742138,36742138,1.2247379333333333,False,10,"['Crime', 'Drama', 'Mystery']",7.1
584,Silence,46500000,23726626,-22773374,-0.48974997849462365,False,12,"['Drama', 'Thriller']",4.6
1907,Silent House,2000000,16610760,14610760,7.30538,True,1,"['Drama', 'Horror', 'Mystery']",5.3
1055,Silver Linings Playbook,21000000,236412453,215412453,10.257735857142857,True,12,"['Comedy', 'Drama', 'Romance']",7.7
2003,Simon,1300000,1738663,438663,0.33743307692307695,False,2,['Thriller'],4.8
444,Sin City: A Dame to Kill For,65000000,40650842,-24349158,-0.3746024307692308,False,8,"['Crime', 'Thriller']",6.5
378,Sing,75000000,634454789,559454789,7.459397186666667,True,12,"['Animation', 'Comedy', 'Family']",7.1
1825,Sinister,3000000,87727807,84727807,28.242602333333334,True,10,"['Horror', 'Mystery', 'Thriller']",6.8
1429,Sinister 2,10000000,54104225,44104225,4.4104225,True,8,"['Horror', 'Mystery', 'Thriller']",5.3
813,Sisters,30000000,106030660,76030660,2.5343553333333335,True,12,"['Action', 'Drama']",4.7
1538,Skin Trade,9000000,1242,-8998758,-0.999862,False,11,['Documentary'],8.8
47,Skyfall,200000000,1110526981,910526981,4.552634905,True,11,"['Action', 'Adventure', 'Thriller']",7.8
1437,Skyline,10000000,68264973,58264973,5.8264973,True,11,"['Action', 'Sci-Fi', 'Thriller']",4.4
229,Skyscraper,125000000,304115534,179115534,1.432924272,False,7,"['Action', 'Adventure', 'Thriller']",5.8
2147,Sleight,250000,3934450,3684450,14.7378,True,4,"['Action', 'Drama', 'Sci-Fi']",5.9
1427,Slender Man,10000000,51723644,41723644,4.1723644,True,8,"['Adventure', 'Comedy', 'Horror']",5.9
1948,Small Apartments,2000000,0,-2000000,-1.0,False,3,"['Comedy', 'Crime', 'Drama']",6.1
361,Smallfoot,80000000,213691277,133691277,1.6711409625,False,9,"['Adventure', 'Animation', 'Comedy']",6.7
473,Smurfs: The Lost Village,60000000,197578586,137578586,2.292976433333333,True,4,"['Adventure', 'Animation', 'Comedy']",6.0
617,Snatched,42000000,57852177,15852177,0.37743278571428573,False,1,['Comedy'],5.5
1247,Snitch,15000000,57907734,42907734,2.8605156,True,1,"['Action', 'Drama', 'Thriller']",6.5
1632,Snow Flower and the Secret Fan,6000000,11348205,5348205,0.8913675,False,7,"['Drama', 'History']",6.1
101,Snow White and the Huntsman,170000000,401021746,231021746,1.3589514470588235,False,6,"['Action', 'Adventure', 'Drama']",6.1
2059,Snow White: A Deadly Summer,1000000,0,-1000000,-1.0,False,3,['Horror'],2.2
563,Snowden,50000000,35380918,-14619082,-0.29238164,False,9,"['Biography', 'Drama', 'Thriller']",7.3
688,Snowpiercer,40000000,88069880,48069880,1.201747,False,6,"['Action', 'Drama', 'Sci-Fi']",7.1
9,Solo: A Star Wars Story,275000000,393151347,118151347,0.4296412618181818,False,5,"['Action', 'Adventure', 'Fantasy']",7.0
2142,Some Guy Who Kills People,300000,0,-300000,-1.0,False,10,"['Comedy', 'Crime', 'Drama']",6.3
738,Something Borrowed,35000000,65084116,30084116,0.8595461714285715,False,5,"['Comedy', 'Drama', 'Romance']",5.9
1862,Something Wicked,3000000,0,-3000000,-1.0,False,4,"['Drama', 'Horror', 'Mystery']",4.8
1599,Somewhere,7000000,17023121,10023121,1.4318744285714287,False,12,"['Comedy', 'Drama']",6.3
1036,Son of God,22000000,70949793,48949793,2.224990590909091,True,2,['Documentary'],6.8
1640,Song One,6000000,437089,-5562911,-0.9271518333333333,False,1,"['Drama', 'Music']",5.8
1816,Sorry to Bother You,3200000,18285560,15085560,4.7142375,True,7,"['Comedy', 'Fantasy', 'Sci-Fi']",7.0
1174,Soul Surfer,18000000,47158652,29158652,1.619925111111111,False,4,"['Biography', 'Drama', 'Family']",7.1
2184,Sound of My Voice,135000,429448,294448,2.181096296296296,True,1,"['Drama', 'Mystery', 'Sci-Fi']",6.6
795,Source Code,32000000,140428499,108428499,3.38839059375,True,4,"['Action', 'Drama', 'Sci-Fi']",7.5
823,Southpaw,30000000,94156456,64156456,2.138548533333333,True,7,"['Drama', 'Sport']",7.4
883,Space Pirate Captain Harlock,30000000,310985,-29689015,-0.9896338333333333,False,8,"['Animation', 'Sci-Fi']",7.1
1434,Sparkle,10000000,24660323,14660323,1.4660323,False,8,"['Drama', 'Music']",5.7
2177,Sparrows Dance,175000,2602,-172398,-0.9851314285714285,False,8,"['Comedy', 'Drama', 'Romance']",6.8
2182,Speak No Evil,150000,32927,-117073,-0.7804866666666667,False,5,['Horror'],3.6
6,Spectre,300000000,879620923,579620923,1.9320697433333334,False,11,"['Action', 'Adventure', 'Thriller']",6.8
1983,Spellbound,1500000,7000000,5500000,3.6666666666666665,True,8,"['Comedy', 'Horror', 'Romance']",6.9
89,Spider-Man: Homecoming,175000000,880166350,705166350,4.029522,True,7,"['Action', 'Adventure', 'Sci-Fi']",7.5
1669,Split,5000000,278964806,273964806,54.7929612,True,4,['Crime'],6.8
1083,Spotlight,20000000,92088460,72088460,3.604423,True,1,['Drama'],8.0
1698,Spring Breakers,5000000,31149251,26149251,5.2298502,True,3,"['Comedy', 'Crime', 'Drama']",5.3
1322,St. Vincent,13000000,54837234,41837234,3.2182487692307693,True,10,"['Comedy', 'Drama']",7.3
1780,Stake Land,4000000,679482,-3320518,-0.8301295,False,10,"['Drama', 'Horror', 'Sci-Fi']",6.5
1650,Standing Ovation,5600000,531806,-5068194,-0.9050346428571429,False,7,['Musical'],3.3
70,Star Trek Beyond,185000000,335802233,150802233,0.8151472054054054,False,7,"['Action', 'Adventure', 'Sci-Fi']",7.1
60,Star Trek Into Darkness,190000000,467381584,277381584,1.4599030736842105,False,5,"['Action', 'Adventure', 'Sci-Fi']",7.7
477,State of Play,60000000,88832210,28832210,0.48053683333333336,False,9,"['Documentary', 'Drama', 'Sport']",6.5
1234,Steel,16000000,1686429,-14313571,-0.8945981875,False,11,['Drama'],5.7
831,Step Up 3D,30000000,165889117,135889117,4.529637233333333,True,8,"['Drama', 'Music', 'Romance']",6.2
785,Step Up Revolution,33000000,165552290,132552290,4.0167360606060605,True,7,"['Drama', 'Music', 'Romance']",6.5
863,Steve Jobs,30000000,35579007,5579007,0.1859669,False,10,"['Biography', 'Drama']",7.2
1694,Still Alice,5000000,41699612,36699612,7.3399224,True,12,['Drama'],7.5
1940,Stitches,2000000,63555,-1936445,-0.9682225,False,10,['Drama'],5.8
1381,Stoker,12000000,12034913,34913,0.0029094166666666665,False,3,"['Drama', 'Thriller']",6.8
774,Stolen,35000000,17967746,-17032254,-0.48663582857142856,False,9,"['Crime', 'Drama']",4.5
1052,Stone,22000000,4065020,-17934980,-0.8152263636363636,False,10,"['Crime', 'Drama', 'Thriller']",5.6
1927,Stonewall,2000000,304602,-1695398,-0.847699,False,9,"['Drama', 'History']",5.1
400,Storks,70000000,183353431,113353431,1.6193347285714286,False,9,"['Adventure', 'Animation', 'Comedy']",6.8
1945,Straight A's,2000000,0,-2000000,-1.0,False,3,"['Comedy', 'Drama']",5.7
892,Straight Outta Compton,28000000,202182981,174182981,6.22082075,True,8,"['Biography', 'Drama', 'History']",7.9
1963,Stranded,1900000,285593,-1614407,-0.8496878947368421,False,7,['Documentary'],7.9
1503,Strangerland,10000000,161097,-9838903,-0.9838903,False,7,"['Drama', 'Mystery', 'Thriller']",5.2
994,Straw Dogs,25000000,11253821,-13746179,-0.54984716,False,9,"['Action', 'Drama', 'Thriller']",5.8
875,Stronger,30000000,8786752,-21213248,-0.7071082666666667,False,9,"['Action', 'Sport']",8.4
1723,Stuck,5000000,67505,-4932495,-0.986499,False,2,"['Comedy', 'Drama']",8.8
1886,Stung,2500000,0,-2500000,-1.0,False,7,"['Action', 'Adventure', 'Comedy']",5.1
2122,Subconscious,500000,0,-500000,-1.0,False,3,['Horror'],4.5
1958,Submarine,1900000,4581937,2681937,1.4115457894736843,False,6,"['Comedy', 'Drama', 'Romance']",7.3
390,Sucker Punch,75000000,89758389,14758389,0.19677852,False,3,"['Action', 'Adventure', 'Fantasy']",6.1
1303,Suffragette,14000000,34044909,20044909,1.4317792142857142,False,10,"['Biography', 'Drama', 'History']",6.9
90,Suicide Squad,175000000,746059887,571059887,3.2631993542857143,True,8,"['Action', 'Adventure', 'Fantasy']",6.0
456,Sully,60000000,238524556,178524556,2.9754092666666665,True,9,"['Biography', 'Drama']",7.5
1879,Super,2500000,593933,-1906067,-0.7624268,False,3,['Drama'],8.1
531,Super 8,50000000,257972745,207972745,4.1594549,True,6,"['Mystery', 'Sci-Fi', 'Thriller']",7.0
1297,Superstar,14000000,30628981,16628981,1.1877843571428572,False,8,['Drama'],4.0
2200,Supporting Characters,60000,4917,-55083,-0.91805,False,1,['Comedy'],6.4
1147,Survivor,20000000,1703281,-18296719,-0.91483595,False,5,"['Biography', 'Crime', 'Documentary']",9.0
1137,Suspiria,20000000,7034615,-12965385,-0.64826925,False,10,"['Fantasy', 'Horror', 'Mystery']",6.8
1578,Swelter,8000000,44197,-7955803,-0.994475375,False,4,"['Action', 'Crime', 'Drama']",4.6
1833,Swiss Army Man,3000000,5837111,2837111,0.9457036666666667,False,6,"['Adventure', 'Comedy', 'Drama']",7.0
1708,Table 19,5000000,4620399,-379601,-0.0759202,False,3,"['Comedy', 'Drama', 'Romance']",5.8
901,Tag,28000000,77026186,49026186,1.7509352142857142,False,5,['Drama'],4.6
1162,Take Me Home Tonight,19000000,7576604,-11423396,-0.6012313684210526,False,3,"['Comedy', 'Drama', 'Romance']",6.3
1740,Take Shelter,4750000,4972016,222016,0.04674021052631579,False,9,"['Drama', 'Horror', 'Thriller']",7.4
588,Taken 2,45000000,377807404,332807404,7.395720088888889,True,10,"['Action', 'Thriller']",6.3
577,Taken 3,48000000,327656424,279656424,5.8261755,True,1,"['Action', 'Thriller']",6.0
794,Takers,32000000,70587268,38587268,1.205852125,False,8,"['Action', 'Crime', 'Thriller']",6.2
1072,Tammy,20000000,96407655,76407655,3.82038275,True,7,"['Comedy', 'Romance']",4.9
12,Tangled,260000000,586477240,326477240,1.2556816923076923,False,11,"['Adventure', 'Animation', 'Comedy']",7.8
157,Tarzan,145000000,448191819,303191819,2.0909780620689653,True,12,"['Adventure', 'Animation', 'Drama']",4.8
527,Ted,50000000,556016627,506016627,10.12033254,True,6,"['Comedy', 'Fantasy']",6.9
419,Ted 2,68000000,217214143,149214143,2.194325632352941,True,6,['Comedy'],6.3
1992,Teefa in Trouble,1500000,98806,-1401194,-0.9341293333333334,False,7,"['Action', 'Comedy', 'Crime']",7.4
219,Teenage Mutant Ninja Turtles,125000000,485004754,360004754,2.880038032,True,8,"['Action', 'Adventure', 'Comedy']",5.8
173,Teenage Mutant Ninja Turtles: Out of the Shadows,135000000,245328374,110328374,0.8172472148148148,False,6,"['Action', 'Adventure', 'Comedy']",6.0
1925,Teeth,2000000,2350641,350641,0.1753205,False,1,['Drama'],8.8
2143,Teeth and Blood,300000,0,-300000,-1.0,False,3,"['Action', 'Horror']",4.0
2222,Ten,25000,0,-25000,-1.0,False,3,['Drama'],5.5
2155,Test,250000,18823,-231177,-0.924708,False,10,['Drama'],7.2
1485,Testament of Youth,10000000,6646669,-3353331,-0.3353331,False,6,"['Biography', 'Drama', 'History']",7.3
1094,Texas Chainsaw 3D,20000000,47666013,27666013,1.38330065,False,1,"['Horror', 'Thriller']",4.8
1124,Thank You for Your Service,20000000,9985316,-10014684,-0.5007342,False,10,"['Documentary', 'Drama']",7.7
1552,That Awkward Moment,8000000,53068955,45068955,5.633619375,True,1,"['Comedy', 'Romance']",6.2
495,That's My Boy,57500000,58085235,585235,0.010178,False,6,['Comedy'],5.6
838,The 15:17 to Paris,30000000,56096200,26096200,0.8698733333333334,False,2,"['Biography', 'Drama', 'Thriller']",5.2
992,The 33,25000000,28400715,3400715,0.1360286,False,11,"['Biography', 'Drama', 'History']",6.9
1635,The 5th Quarter,6000000,408159,-5591841,-0.9319735,False,3,"['Biography', 'Drama', 'Sport']",5.7
697,The 5th Wave,38000000,111336398,73336398,1.9299052105263157,False,1,"['Action', 'Adventure', 'Drama']",5.2
261,The A-Team,110000000,177241171,67241171,0.6112833727272727,False,6,"['Action', 'Adventure', 'Thriller']",6.8
639,The Accountant,40000000,152962083,112962083,2.824052075,True,10,"['Action', 'Crime', 'Drama']",7.3
2045,The Act of Killing,1000000,1227316,227316,0.227316,False,8,"['Crime', 'Documentary']",8.2
526,The Adjustment Bureau,50200000,126931325,76731325,1.5285124501992031,False,3,"['Romance', 'Sci-Fi', 'Thriller']",7.1
1006,The Adventurer: The Curse of the Midas Box,25000000,0,-25000000,-1.0,False,12,"['Adventure', 'Family', 'Fantasy']",5.4
211,The Adventures of Tintin,130000000,373993951,243993951,1.8768765461538461,False,12,"['Action', 'Adventure', 'Animation']",7.3
830,The Age of Adaline,30000000,68984536,38984536,1.2994845333333334,False,4,"['Drama', 'Fantasy', 'Romance']",7.2
2004,The Algerian,1300000,0,-1300000,-1.0,False,8,"['Action', 'Romance', 'Thriller']",5.3
23,The Amazing Spider-Man,220000000,757890267,537890267,2.444955759090909,True,7,"['Action', 'Adventure', 'Sci-Fi']",7.0
51,The Amazing Spider-Man 2,200000000,708996336,508996336,2.54498168,True,5,"['Action', 'Adventure', 'Sci-Fi']",6.6
1093,The American,20000000,67950723,47950723,2.39753615,True,9,"['Crime', 'Drama', 'Thriller']",6.3
396,The Angry Birds Movie,73000000,352327887,279327887,3.826409410958904,True,5,"['Action', 'Animation', 'Comedy']",6.3
1216,The Apparition,17000000,10637281,-6362719,-0.3742775882352941,False,8,['Drama'],6.4
1768,The Art of Getting By,4000000,1989035,-2010965,-0.50274125,False,6,"['Drama', 'Romance']",6.6
1224,The Artist,16000000,128256712,112256712,7.0160445,True,10,['Thriller'],6.8
20,The Avengers,225000000,1517935897,1292935897,5.746381764444444,True,5,"['Action', 'Adventure', 'Sci-Fi']",8.1
1737,The Awakening,4900000,6924321,2024321,0.41312673469387756,False,10,"['Horror', 'Thriller']",2.4
166,The BFG,140000000,199646680,59646680,0.4260477142857143,False,7,"['Adventure', 'Family', 'Fantasy']",6.4
1923,The Babadook,2000000,7482387,5482387,2.7411935,True,11,"['Drama', 'Horror']",6.8
1062,The Beaver,21000000,5046038,-15953962,-0.7597124761904762,False,5,['Drama'],6.7
1702,The Belko Experiment,5000000,11792942,6792942,1.3585884,False,3,"['Horror', 'Thriller']",6.1
1417,The Best Exotic Marigold Hotel,10000000,134639780,124639780,12.463978,True,5,"['Comedy', 'Drama', 'Romance']",7.3
1209,The Best Man Holiday,17000000,72835710,55835710,3.2844535294117647,True,11,"['Comedy', 'Drama']",6.7
928,The Best of Me,26000000,41059418,15059418,0.5792083846153846,False,10,"['Drama', 'Romance']",6.7
898,The Big Short,28000000,133162752,105162752,3.7558125714285713,True,12,"['Biography', 'Comedy', 'Drama']",7.8
1679,The Big Sick,5000000,53972860,48972860,9.794572,True,6,"['Comedy', 'Drama', 'Romance']",7.6
792,The Big Wedding,32500000,48425971,15925971,0.4900298769230769,False,4,"['Comedy', 'Drama', 'Romance']",5.6
628,The Big Year,41000000,7684524,-33315476,-0.8125725853658536,False,10,['Comedy'],6.2
1444,The Birth of a Nation,10000000,16891011,6891011,0.6891011,False,10,"['Biography', 'Drama', 'History']",6.4
1092,The Black Hole,20000000,35841901,15841901,0.79209505,False,5,['Comedy'],4.2
1161,The Book Thief,19000000,76086711,57086711,3.004563736842105,True,11,"['Drama', 'War']",7.6
359,The Book of Eli,80000000,158750817,78750817,0.9843852125,False,1,"['Action', 'Adventure', 'Drama']",6.9
548,The Book of Life,50000000,97651543,47651543,0.95303086,False,10,['Thriller'],6.7
888,The Boss,29000000,78652207,49652207,1.7121450689655173,False,4,['Comedy'],5.4
222,The Boss Baby,125000000,510878762,385878762,3.087030096,True,3,"['Adventure', 'Animation', 'Comedy']",6.3
1850,The Bounce Back,3000000,421404,-2578596,-0.859532,False,2,"['Comedy', 'Romance']",5.0
595,The Bounty Hunter,45000000,135808837,90808837,2.0179741555555557,True,3,['nan'],6.3
228,The Bourne Legacy,125000000,280355920,155355920,1.24284736,False,8,"['Action', 'Adventure', 'Thriller']",6.7
982,The Box,25000000,34356760,9356760,0.3742704,False,11,['Drama'],6.3
467,The Boxtrolls,60000000,111946251,51946251,0.86577085,False,9,"['Adventure', 'Animation', 'Comedy']",6.8
1422,The Boy,10000000,68220952,58220952,5.8220952,True,1,"['Drama', 'Horror', 'Thriller']",5.4
1761,The Boy Next Door,4000000,53401938,49401938,12.3504845,True,1,"['Horror', 'Thriller']",4.7
2079,The Brass Teapot,900000,413733,-486267,-0.5402966666666666,False,4,"['Comedy', 'Fantasy', 'Thriller']",6.4
1805,The Bronze,3500000,615816,-2884184,-0.8240525714285715,False,3,"['Comedy', 'Drama', 'Sport']",6.0
1585,The Bye Bye Man,7400000,31187727,23787727,3.214557702702703,True,1,"['Drama', 'Fantasy', 'Horror']",4.3
832,The Cabin in the Woods,30000000,70689968,40689968,1.3563322666666666,False,4,['Horror'],7.0
1341,The Call,12800000,69821476,57021476,4.4548028125,True,3,['Thriller'],6.6
1883,The Calling,2500000,0,-2500000,-1.0,False,8,['Biography'],6.7
305,The Campaign,95000000,104907746,9907746,0.10429206315789474,False,8,['Documentary'],6.9
2153,The Canyons,250000,62375,-187625,-0.7505,False,7,"['Drama', 'Thriller']",3.8
523,The Change-Up,52000000,75997067,23997067,0.4614820576923077,False,8,"['Comedy', 'Fantasy']",6.3
2159,The Christmas Bunny,250000,0,-250000,-1.0,False,11,"['Drama', 'Family']",6.1
1602,The Christmas Candle,7000000,1933829,-5066171,-0.7237387142857142,False,11,"['Drama', 'Family']",6.2
130,The Chronicles of Narnia: The Voyage of the Dawn Treader,155000000,418186950,263186950,1.6979803225806451,False,12,"['Adventure', 'Family', 'Fantasy']",6.3
1180,The Circle,18000000,40651864,22651864,1.2584368888888888,False,10,"['Adventure', 'Documentary', 'History']",7.6
1136,The Cold Light of Day,20000000,25361206,5361206,0.2680603,False,9,"['Action', 'Thriller']",4.9
1471,The Collection,10000000,8890094,-1109906,-0.1109906,False,3,"['Action', 'Horror', 'Thriller']",6.1
1830,The Collector,3000000,10473836,7473836,2.4912786666666666,True,6,"['Action', 'Comedy']",7.1
1281,The Comedian,15000000,1658706,-13341294,-0.8894196,False,12,"['Drama', 'Romance']",5.5
665,The Commuter,40000000,101985431,61985431,1.549635775,False,1,"['Action', 'Mystery', 'Thriller']",6.3
1067,The Conjuring,20000000,318000141,298000141,14.90000705,True,7,"['Horror', 'Mystery', 'Thriller']",7.5
993,The Conspirator,25000000,15907411,-9092589,-0.36370356,False,4,"['Crime', 'Drama', 'History']",6.9
1730,The Cottage,5000000,1504960,-3495040,-0.699008,False,12,"['Drama', 'Horror', 'Thriller']",4.8
969,The Counselor,25000000,71009334,46009334,1.84037336,False,10,"['Crime', 'Drama', 'Thriller']",5.3
1106,The Covenant,20000000,38164784,18164784,0.9082392,False,2,['Musical'],6.2
1157,The Crazies,19000000,56445534,37445534,1.9708175789473685,False,2,"['Horror', 'Thriller']",6.5
1028,The Crew,23000000,13019253,-9980747,-0.4339455217391304,False,9,"['Crime', 'Drama', 'Thriller']",6.3
168,The Croods,135000000,573068425,438068425,3.2449512962962963,True,3,"['Action', 'Adventure', 'Animation']",7.2
1952,The Curse of Downers Grove,2000000,0,-2000000,-1.0,False,8,"['Drama', 'Horror', 'Mystery']",4.5
1846,The D Train,3000000,772366,-2227634,-0.7425446666666666,False,1,"['Comedy', 'Drama']",5.0
8,The Dark Knight Rises,275000000,1084439099,809439099,2.9434149054545453,True,7,"['Action', 'Thriller']",8.4
468,The Dark Tower,60000000,113461527,53461527,0.89102545,False,8,"['Action', 'Adventure', 'Fantasy']",5.7
778,The Darkest Hour,34800000,62831715,28031715,0.8055090517241379,False,12,"['Documentary', 'News']",6.4
782,The Darkest Minds,34000000,38361428,4361428,0.12827729411764707,False,8,"['Action', 'Adventure', 'Drama']",5.7
1766,The Darkness,4000000,10898293,6898293,1.72457325,False,5,['Thriller'],5.7
2020,The Dead Undead,1100000,0,-1100000,-1.0,False,5,"['Action', 'Horror', 'Sci-Fi']",3.0
1101,The Debt,20000000,46604054,26604054,1.3302027,False,8,"['Drama', 'Mystery', 'Thriller']",6.1
1073,The Descendants,20000000,175507800,155507800,7.77539,True,11,['Drama'],7.5
2022,The Devil Inside,1000000,101759490,100759490,100.75949,True,1,['Horror'],4.2
1154,The Devil's Double,19100000,5965646,-13134354,-0.6876625130890053,False,7,"['Biography', 'Drama', 'Thriller']",7.1
1920,The Diary of a Teenage Girl,2000000,2279959,279959,0.1399795,False,8,"['Comedy', 'Drama', 'Romance']",6.9
435,The Dictator,65000000,180148897,115148897,1.7715214923076923,False,5,['Comedy'],6.4
407,The Dilemma,70000000,70546865,546865,0.007812357142857143,False,1,"['Comedy', 'Drama']",5.3
2203,The Dirties,55000,0,-55000,-1.0,False,10,"['Crime', 'Drama']",6.8
1280,The Disappointments Room,15000000,3503761,-11496239,-0.7664159333333334,False,9,"['Drama', 'Horror', 'Thriller']",3.9
1438,The Disaster Artist,10000000,28717667,18717667,1.8717667,False,12,"['Biography', 'Comedy', 'Drama']",7.4
1855,The Divide,3000000,156362,-2843638,-0.9478793333333333,False,1,['Western'],7.9
1954,The Dog Lover,2000000,0,-2000000,-1.0,False,7,['Drama'],5.6
1342,The Drop,12600000,19054534,6454534,0.5122646031746032,False,9,"['Crime', 'Drama']",7.1
965,The Eagle,25000000,38993548,13993548,0.55974192,False,2,"['Action', 'Adventure', 'Drama']",6.2
1618,The East,6500000,3027956,-3472044,-0.5341606153846153,False,5,"['Adventure', 'Drama', 'Thriller']",6.8
1529,The Edge of Seventeen,9000000,19096003,10096003,1.1217781111111111,False,11,"['Comedy', 'Drama']",7.3
538,The Emoji Movie,50000000,216562312,166562312,3.33124624,True,7,"['Adventure', 'Animation', 'Comedy']",3.2
503,The Equalizer,55000000,192903624,137903624,2.507338618181818,True,9,"['Action', 'Crime', 'Thriller']",7.2
375,The Equalizer 2,77000000,190453132,113453132,1.4734172987012988,False,7,"['Action', 'Crime', 'Thriller']",6.7
350,The Expendables,82000000,268268174,186268174,2.2715630975609757,True,8,"['Action', 'Adventure', 'Thriller']",6.5
279,The Expendables 2,100000000,311979256,211979256,2.11979256,True,8,"['Action', 'Adventure', 'Thriller']",6.6
284,The Expendables 3,100000000,209461378,109461378,1.09461378,False,8,"['Action', 'Adventure', 'Thriller']",6.1
1605,The Extra Man,7000000,492108,-6507892,-0.9296988571428572,False,8,['Comedy'],5.9
2201,The FP,60000,0,-60000,-1.0,False,3,['Comedy'],5.6
1775,The Face of Love,4000000,1158877,-2841123,-0.71028075,False,3,"['Drama', 'Mystery', 'Romance']",6.2
934,The Face of an Angel,26000000,0,-26000000,-1.0,False,3,"['Crime', 'Drama']",4.6
837,The Family,30000000,51078541,21078541,0.7026180333333333,False,10,"['Comedy', 'Crime', 'Drama']",7.5
18,The Fate of the Furious,250000000,1234846267,984846267,3.939385068,True,4,"['Action', 'Crime', 'Thriller']",6.7
1348,The Fault in Our Stars,12000000,307166834,295166834,24.597236166666665,True,5,"['Drama', 'Romance']",7.7
1257,The Favourite,15000000,94113929,79113929,5.274261933333333,True,11,"['Biography', 'Drama', 'History']",7.6
931,The Fifth Estate,26000000,6154172,-19845828,-0.7633010769230769,False,10,"['Biography', 'Drama', 'Thriller']",6.2
1395,The Fighter,11000000,129262388,118262388,10.751126181818181,True,12,"['Biography', 'Drama', 'Sport']",7.8
1752,The Final Girls,4500000,0,-4500000,-1.0,False,10,"['Comedy', 'Horror']",5.4
410,The Finest Hours,70000000,49252761,-20747239,-0.2963891285714286,False,1,"['Action', 'Drama', 'History']",6.8
1318,The First Purge,13000000,136617305,123617305,9.509023461538462,True,7,"['Action', 'Horror', 'Sci-Fi']",5.1
1932,The First Time,2000000,17061,-1982939,-0.9914695,False,10,"['Comedy', 'Drama', 'Romance']",6.9
2179,The Fits,170000,169242,-758,-0.004458823529411765,False,1,"['Drama', 'Music']",6.7
852,The Five-Year Engagement,30000000,61623819,31623819,1.0541273,False,4,"['Comedy', 'Romance']",6.2
1911,The Florida Project,2000000,11295324,9295324,4.647662,True,10,['Drama'],7.6
745,The Foreigner,35000000,140783360,105783360,3.0223817142857143,True,10,"['Comedy', 'Romance']",6.8
1431,The Forest,10000000,40749230,30749230,3.074923,True,1,"['Documentary', 'History']",7.1
1270,The Founder,15000000,24403192,9403192,0.6268794666666667,False,1,"['Comedy', 'Sci-Fi']",5.9
2160,The Frozen,250000,0,-250000,-1.0,False,10,"['Drama', 'Thriller']",4.4
1153,The Frozen Ground,19200000,5617460,-13582540,-0.7074239583333334,False,8,"['Crime', 'Drama', 'Mystery']",6.4
2042,The Future,1000000,1239174,239174,0.239174,False,7,"['Drama', 'Fantasy', 'Romance']",6.2
2186,The Gallows,100000,41656474,41556474,415.56474,True,7,"['Horror', 'Mystery', 'Thriller']",4.2
956,The Gambler,25000000,38718031,13718031,0.54872124,False,12,['Drama'],7.0
1985,The Gatekeepers,1500000,2592308,1092308,0.7282053333333334,False,2,"['Documentary', 'History', 'War']",7.6
1937,The Ghastly Love of Johnny X,2000000,2436,-1997564,-0.998782,False,4,"['Comedy', 'Fantasy', 'Musical']",5.7
603,The Ghost Writer,45000000,65532491,20532491,0.4562775777777778,False,2,"['Drama', 'Mystery', 'Thriller']",7.2
2078,The Giant Mechanical Man,900000,7396,-892604,-0.9917822222222222,False,4,"['Comedy', 'Drama', 'Romance']",6.7
1451,The Gift,10000000,44567606,34567606,3.4567606,True,1,['Documentary'],6.2
593,The Girl on the Train,45000000,174278214,129278214,2.8728492,True,10,['Thriller'],4.4
320,The Girl with the Dragon Tattoo,90000000,239373970,149373970,1.6597107777777778,False,12,"['Crime', 'Drama', 'Mystery']",7.8
949,The Giver,25000000,66540205,41540205,1.6616082,False,8,"['Drama', 'Romance', 'Sci-Fi']",6.5
65,The Good Dinosaur,187500000,333771037,146271037,0.7801121973333334,False,11,"['Adventure', 'Animation', 'Comedy']",6.7
1405,The Gospel of John,11000000,4234355,-6765645,-0.6150586363636363,False,12,['Drama'],7.8
2167,The Grace Card,200000,2430735,2230735,11.153675,True,2,['Drama'],6.6
805,The Grand Budapest Hotel,31000000,163981261,132981261,4.289718096774194,True,3,"['Adventure', 'Comedy', 'Crime']",8.1
62,The Great Gatsby,190000000,351040419,161040419,0.847581152631579,False,5,"['Drama', 'Romance']",7.3
152,The Great Wall,150000000,334486852,184486852,1.2299123466666666,False,2,['Documentary'],6.5
347,The Greatest Showman,84000000,386665550,302665550,3.6031613095238093,True,12,"['Biography', 'Drama', 'Musical']",7.6
259,The Green Hornet,110000000,229155503,119155503,1.0832318454545455,False,1,"['Action', 'Comedy', 'Crime']",5.8
2029,The Green Inferno,1000000,12931420,11931420,11.93142,True,11,"['Adventure', 'Horror']",5.3
945,The Grey,25000000,81249176,56249176,2.24996704,True,1,"['Action', 'Adventure', 'Drama']",6.8
1629,The Guard,6000000,21197454,15197454,2.532909,True,7,"['Comedy', 'Crime', 'Thriller']",7.3
405,The Guardian,70000000,94973540,24973540,0.35676485714285716,False,10,"['Action', 'Mystery', 'Sci-Fi']",6.7
663,The Guilt Trip,40000000,41294674,1294674,0.03236685,False,12,"['Comedy', 'Drama']",5.8
680,The Gunman,40000000,18594227,-21405773,-0.535144325,False,3,"['Action', 'Crime', 'Drama']",5.8
2080,The Hammer,850000,442638,-407362,-0.47924941176470587,False,10,"['Action', 'Adventure', 'Documentary']",6.5
352,The Hangover Part II,80000000,586464305,506464305,6.3308038125,True,5,"['Comedy', 'Mystery']",6.5
1023,The Hate U Give,23000000,35067665,12067665,0.5246810869565217,False,10,"['Crime', 'Drama']",7.3
450,The Hateful Eight,62000000,147864886,85864886,1.3849175161290324,False,12,"['Crime', 'Drama', 'Mystery']",7.8
612,The Heat,43000000,229727774,186727774,4.342506372093023,True,6,"['Action', 'Comedy', 'Crime']",6.6
935,The Help,25000000,213120004,188120004,7.52480016,True,8,['Drama'],8.1
1646,The Hit List,6000000,0,-6000000,-1.0,False,4,"['Action', 'Thriller']",5.4
15,The Hobbit: An Unexpected Journey,250000000,1017003568,767003568,3.068014272,True,12,"['Adventure', 'Family', 'Fantasy']",7.9
17,The Hobbit: The Battle of the Five Armies,250000000,945577621,695577621,2.782310484,True,12,"['Adventure', 'Fantasy']",7.4
16,The Hobbit: The Desolation of Smaug,250000000,960366855,710366855,2.84146742,True,12,"['Adventure', 'Fantasy']",7.8
1230,The Homesman,16000000,8217571,-7782429,-0.4864018125,False,8,"['Drama', 'Western']",6.6
559,The Host,50000000,64477051,14477051,0.28954102,False,3,['Documentary'],6.4
674,The House,40000000,31192425,-8807575,-0.220189375,False,6,"['Drama', 'Mystery', 'Thriller']",4.6
1037,The Hundred-Foot Journey,22000000,94270488,72270488,3.285022181818182,True,8,"['Comedy', 'Drama']",7.3
351,The Hunger Games,80000000,677923379,597923379,7.4740422375,True,3,"['Action', 'Adventure', 'Sci-Fi']",7.2
178,The Hunger Games: Catching Fire,130000000,864868047,734868047,5.652831130769231,True,11,"['Action', 'Adventure', 'Sci-Fi']",7.5
217,The Hunger Games: Mockingjay - Part 1,125000000,766575131,641575131,5.132601048,True,11,"['Action', 'Adventure', 'Sci-Fi']",6.6
121,The Hunger Games: Mockingjay - Part 2,160000000,648986787,488986787,3.05616741875,True,11,"['Action', 'Adventure', 'Sci-Fi']",6.6
512,The Hunted,55000000,47213095,-7786905,-0.1415800909090909,False,9,"['Action', 'Comedy', 'Horror']",6.5
685,The Hurricane Heist,40000000,30963684,-9036316,-0.2259079,False,3,"['Action', 'Adventure', 'Crime']",5.1
1484,The Iceman,10000000,3623609,-6376391,-0.6376391,False,9,"['Biography', 'Crime', 'Drama']",6.9
1022,The Ides of March,23000000,77735925,54735925,2.3798228260869565,True,10,"['Drama', 'Thriller']",7.1
1222,The Illusionist,16500000,83792062,67292062,4.0783067878787875,True,12,"['Animation', 'Drama']",7.5
2209,The Image Revolution,50000,0,-50000,-1.0,False,11,"['Biography', 'Documentary']",7.2
1238,The Imitation Game,15000000,227740463,212740463,14.182697533333334,True,12,"['Biography', 'Drama', 'Thriller']",8.0
1233,The Immigrant,16000000,7585011,-8414989,-0.5259368125,False,10,"['Drama', 'Romance']",6.6
678,The Impossible,40000000,169590606,129590606,3.23976515,True,12,"['Drama', 'History', 'Thriller']",7.6
798,The Incredible Burt Wonderstone,32000000,27392609,-4607391,-0.14398096875,False,3,"['Adventure', 'Comedy', 'Fantasy']",5.9
580,The Infiltrator,47500000,20718104,-26781896,-0.5638293894736842,False,7,"['Biography', 'Crime', 'Drama']",7.0
2088,The Innkeepers,750000,1011535,261535,0.3487133333333333,False,12,"['Drama', 'Horror', 'Mystery']",5.5
645,The Intern,40000000,197115710,157115710,3.92789275,True,9,['nan'],5.5
493,The Internship,58000000,93672764,35672764,0.6150476551724138,False,6,['Comedy'],6.3
611,The Interview,44000000,12342632,-31657368,-0.7194856363636364,False,12,['Comedy'],6.5
2048,The Invitation,1000000,354836,-645164,-0.645164,False,3,"['Drama', 'Horror', 'Mystery']",6.7
1298,The Iron Lady,14000000,115592104,101592104,7.256578857142857,True,12,"['Biography', 'Drama']",6.4
1490,The Joneses,10000000,3541565,-6458435,-0.6458435,False,4,"['Biography', 'Documentary']",5.9
2112,The Journey,500000,19800,-480200,-0.9604,False,6,['Family'],6.4
550,The Judge,50000000,76119388,26119388,0.52238776,False,10,['Documentary'],7.3
85,The Jungle Book,175000000,962854547,787854547,4.502025982857143,True,4,['Animation'],7.0
629,The Karate Kid,40000000,351774938,311774938,7.79437345,True,6,"['Action', 'Drama', 'Family']",6.2
434,The Kid,65000000,69688384,4688384,0.07212898461538461,False,10,"['Comedy', 'Drama', 'Family']",6.4
1763,The Kids Are All Right,4000000,36275469,32275469,8.06886725,True,7,"['Comedy', 'Drama', 'Romance']",7.0
1339,The Killer Inside Me,13000000,3617277,-9382723,-0.721747923076923,False,4,"['Crime', 'Drama', 'Horror']",6.1
1625,The Lady in the Van,6000000,42320503,36320503,6.053417166666667,True,12,"['Biography', 'Comedy', 'Drama']",6.7
147,The Last Airbender,150000000,319713881,169713881,1.1314258733333333,False,7,"['Action', 'Adventure', 'Family']",4.1
1409,The Last Days on Mars,10600000,261364,-10338636,-0.9753430188679245,False,12,"['Adventure', 'Horror', 'Sci-Fi']",5.5
1964,The Last Exorcism,1800000,70165900,68365900,37.98105555555556,True,8,"['Drama', 'Horror', 'Thriller']",5.6
1765,The Last Exorcism Part II,4000000,25448707,21448707,5.36217675,True,3,"['Drama', 'Horror', 'Thriller']",4.0
1928,The Last Five Years,2000000,205298,-1794702,-0.897351,False,2,"['Comedy', 'Drama', 'Musical']",5.9
1312,The Last Godfather,13400000,164247,-13235753,-0.9877427611940298,False,4,"['Comedy', 'Crime', 'Romance']",3.7
1074,The Last Song,20000000,92678948,72678948,3.6339474,True,3,"['Drama', 'Music', 'Romance']",6.0
865,The Last Stand,30000000,48330757,18330757,0.6110252333333334,False,1,"['Action', 'Thriller']",6.4
368,The Last Witch Hunter,80000000,130818912,50818912,0.6352364,False,10,"['Action', 'Adventure', 'Fantasy']",6.0
1687,The Lazarus Effect,5000000,38359310,33359310,6.671862,True,2,"['Horror', 'Mystery', 'Sci-Fi']",5.2
413,The Legend of Hercules,70000000,58953319,-11046681,-0.15780972857142858,False,1,"['Action', 'Adventure', 'Fantasy']",4.2
78,The Legend of Tarzan,180000000,348902025,168902025,0.9383445833333334,False,7,"['Action', 'Adventure', 'Drama']",6.3
353,The Lego Batman Movie,80000000,310660018,230660018,2.883250225,True,2,"['Action', 'Animation', 'Comedy']",7.3
455,The Lego Movie,60000000,457729388,397729388,6.628823133333333,True,2,"['Action', 'Adventure', 'Animation']",7.8
403,The Lego Ninjago Movie,70000000,122737201,52737201,0.7533885857142857,False,9,"['Action', 'Adventure', 'Animation']",6.0
1119,The Light Between Oceans,20000000,22281732,2281732,0.1140866,False,9,"['Drama', 'Romance']",7.2
653,The Lincoln Lawyer,40000000,87145086,47145086,1.17862715,False,3,"['Crime', 'Drama', 'Thriller']",7.3
1994,The Lion of Judah,1500000,0,-1500000,-1.0,False,6,['Animation'],3.8
374,The Little Prince,77500000,102028919,24528919,0.3165021806451613,False,8,['Action'],8.3
1744,The Lobster,4500000,18019834,13519834,3.0044075555555554,True,5,"['Comedy', 'Drama', 'Romance']",7.1
10,The Lone Ranger,275000000,260002115,-14997885,-0.05453776363636364,False,7,"['Action', 'Adventure', 'Western']",6.4
781,The Longest Ride,34000000,63802928,29802928,0.8765567058823529,False,4,"['Drama', 'Romance']",7.1
2140,The Looking Glass,300000,1711,-298289,-0.9942966666666667,False,1,['Fantasy'],5.5
1986,The Lords of Salem,1500000,1541131,41131,0.027420666666666666,False,4,"['Horror', 'Thriller']",5.1
963,The Losers,25000000,29863840,4863840,0.1945536,False,4,['Drama'],1.7
867,The Lost City of Z,30000000,17121823,-12878177,-0.4292725666666667,False,4,"['Adventure', 'Biography', 'Drama']",6.6
1878,The Lost Medallion: The Adventures of Billy Stone,2500000,549632,-1950368,-0.7801472,False,3,"['Adventure', 'Family', 'Fantasy']",4.9
776,The Lovers,35000000,53899,-34946101,-0.9984600285714286,False,2,"['Comedy', 'Drama', 'Romance']",6.1
943,The Lucky One,25000000,96633833,71633833,2.86535332,True,4,"['Drama', 'Romance']",6.5
1972,The Lunchbox,1700000,12231500,10531500,6.195,True,2,"['Drama', 'Romance']",7.8
321,The Magnificent Seven,90000000,162525156,72525156,0.8058350666666667,False,9,"['Action', 'Adventure', 'Western']",6.9
2099,The Maid's Room,600000,0,-600000,-1.0,False,8,['Thriller'],4.5
1477,The Man Who Knew Infinity,10000000,12382122,2382122,0.2382122,False,4,"['Biography', 'Drama']",7.2
1266,The Man with the Iron Fists,15000000,22018988,7018988,0.46793253333333334,False,11,['Action'],5.4
265,The Martian,108000000,655271443,547271443,5.067328175925926,True,10,"['Adventure', 'Drama', 'Sci-Fi']",8.0
1807,The Masked Saint,3500000,182695,-3317305,-0.9478014285714286,False,1,"['Action', 'Biography', 'Crime']",4.6
705,The Master,37500000,50647416,13147416,0.35059776,False,2,"['Action', 'History']",4.8
780,The Maze Runner,34000000,348319861,314319861,9.244701794117647,True,9,"['Action', 'Mystery', 'Sci-Fi']",6.8
615,The Mechanic,42500000,76347393,33847393,0.7964092470588235,False,1,"['Action', 'Crime', 'Thriller']",6.6
1818,The Meddler,3200000,5526942,2326942,0.727169375,False,4,"['Comedy', 'Drama', 'Romance']",6.3
83,The Meg,178000000,529530715,351530715,1.9748916573033708,False,8,"['Action', 'Horror', 'Sci-Fi']",5.7
1619,The Messenger,6500000,1744952,-4755048,-0.7315458461538461,False,12,['Drama'],8.0
399,The Monuments Men,70000000,158702748,88702748,1.2671821142857143,False,2,"['Comedy', 'Drama', 'History']",6.1
480,The Mortal Instruments: City of Bones,60000000,75965567,15965567,0.26609278333333336,False,8,"['Action', 'Fantasy', 'Horror']",5.9
535,The Mule,50000000,170857676,120857676,2.41715352,True,12,"['Comedy', 'Drama']",6.2
56,The Mummy,195000000,409953905,214953905,1.1023277179487179,False,6,"['Action', 'Adventure', 'Fantasy']",5.5
591,The Muppets,45000000,160971922,115971922,2.5771538222222223,True,11,"['Adventure', 'Comedy', 'Family']",7.1
1582,The Neon Demon,7500000,3559803,-3940197,-0.5253596,False,6,"['Horror', 'Thriller']",6.2
858,The Next Three Days,30000000,67255916,37255916,1.2418638666666666,False,11,"['Action', 'Crime', 'Drama']",7.4
553,The Nice Guys,50000000,59596747,9596747,0.19193494,False,5,"['Action', 'Comedy', 'Crime']",7.4
950,The Night Before,25000000,52427346,27427346,1.09709384,False,11,['Horror'],4.7
2194,The Night Visitor,100000,0,-100000,-1.0,False,11,"['Horror', 'Sci-Fi', 'Thriller']",4.8
1261,The November Man,15000000,34820335,19820335,1.3213556666666666,False,8,"['Action', 'Crime', 'Thriller']",6.3
816,The Nut Job,30000000,122529966,92529966,3.0843322,True,1,"['Adventure', 'Animation', 'Comedy']",5.7
672,The Nut Job 2: Nutty by Nature,40000000,57438389,17438389,0.435959725,False,8,"['Adventure', 'Animation', 'Comedy']",5.5
175,The Nutcracker and the Four Realms,132900000,170293899,37393899,0.281368690744921,False,11,"['Adventure', 'Family', 'Fantasy']",5.5
335,The Nutcracker in 3D,90000000,20466016,-69533984,-0.7725998222222222,False,11,"['Action', 'Family', 'Fantasy']",4.3
656,The Odd Life of Timothy Green,40000000,55249159,15249159,0.381228975,False,8,"['Comedy', 'Drama', 'Family']",6.6
573,The One,49000000,72689126,23689126,0.48345155102040815,False,10,['Comedy'],5.4
1815,The Opposite Sex,3300000,50206,-3249794,-0.9847860606060606,False,11,['Comedy'],4.6
2109,The Other Dream Team,500000,314444,-185556,-0.371112,False,9,"['Documentary', 'Sport']",8.4
276,The Other Guys,100000000,170936470,70936470,0.7093647,False,8,"['Action', 'Comedy', 'Crime']",6.7
1713,The Other Side of the Door,5000000,12905107,7905107,1.5810214,False,3,['Drama'],3.8
642,The Other Woman,40000000,195111193,155111193,3.877779825,True,2,"['Comedy', 'Romance']",6.0
2121,The Outrageous Sophie Tucker,500000,0,-500000,-1.0,False,5,['Documentary'],7.3
2168,The Overnight,200000,1165996,965996,4.82998,True,6,['nan'],7.5
1346,The Paperboy,12500000,4027663,-8472337,-0.67778696,False,10,"['Crime', 'Drama', 'Mystery']",5.8
295,The Peanuts Movie,99000000,250091610,151091610,1.5261778787878788,False,11,"['Adventure', 'Animation', 'Comedy']",7.1
1172,The Perfect Guy,18000000,60278166,42278166,2.348787,True,9,"['Crime', 'Drama', 'Horror']",5.6
2052,The Perfect Host,1000000,51587,-948413,-0.948413,False,7,['Fantasy'],7.2
1443,The Perfect Man,10000000,19535005,9535005,0.9535005,False,6,['Romance'],5.2
1703,The Perfect Match,5000000,10182050,5182050,1.03641,False,3,"['Comedy', 'Romance']",4.9
1327,The Perks of Being a Wallflower,13000000,33069303,20069303,1.5437925384615385,False,9,['Drama'],8.0
1262,The Place Beyond the Pines,15000000,47011449,32011449,2.1340966,True,3,"['Crime', 'Drama', 'Thriller']",7.3
601,The Pledge,45000000,29406132,-15593868,-0.3465304,False,8,"['Drama', 'Family']",6.3
1294,The Possession,14000000,82925064,68925064,4.9232188571428575,True,8,"['Horror', 'Mystery', 'Thriller']",5.9
1623,The Possession of Hannah Grace,6000000,42785387,36785387,6.130897833333333,True,11,"['Horror', 'Mystery', 'Thriller']",5.2
539,The Post,50000000,179748880,129748880,2.5949776,True,12,"['Biography', 'Drama', 'History']",7.2
337,The Predator,88000000,159487563,71487563,0.8123586704545455,False,9,"['Action', 'Adventure', 'Sci-Fi']",5.4
1201,The Prince,18000000,0,-18000000,-1.0,False,8,"['Action', 'Thriller']",4.6
332,The Promise,90000000,10551417,-79448583,-0.8827620333333334,False,10,['Thriller'],5.8
1823,The Purge,3000000,91266581,88266581,29.422193666666665,True,6,"['Horror', 'Thriller']",5.7
1524,The Purge: Anarchy,9000000,111534881,102534881,11.392764555555555,True,7,"['Action', 'Horror', 'Sci-Fi']",6.5
1411,The Purge: Election Year,10000000,118514727,108514727,10.8514727,True,7,"['Action', 'Horror', 'Sci-Fi']",6.0
1189,The Railway Man,18000000,23910210,5910210,0.328345,False,4,"['Biography', 'Drama', 'Romance']",7.1
929,The Raven,26000000,30601801,4601801,0.17699234615384615,False,4,"['Crime', 'Mystery', 'Thriller']",6.4
1506,The Reef,10000000,15037867,5037867,0.5037867,False,5,"['Adventure', 'Drama', 'Horror']",5.8
1283,The Reluctant Fundamentalist,15000000,528731,-14471269,-0.9647512666666667,False,3,"['Drama', 'Thriller']",6.9
1919,The Resurrection of Gavin Stone,2000000,2303792,303792,0.151896,False,1,"['Comedy', 'Drama', 'Family']",6.2
1284,The Return,15000000,5953886,-9046114,-0.6030742666666666,False,4,['Drama'],4.8
169,The Revenant,135000000,532938302,397938302,2.947691125925926,True,12,['Horror'],6.0
485,The Ridiculous 6,60000000,0,-60000000,-1.0,False,12,"['Comedy', 'Western']",4.8
1889,The Rise of the Krays,2500000,0,-2500000,-1.0,False,8,"['Crime', 'Drama']",5.0
713,The Rite,37000000,97143987,60143987,1.6255131621621621,False,1,"['Drama', 'Horror', 'Mystery']",6.0
995,The Road,25000000,29206732,4206732,0.16826928,False,5,['Drama'],5.5
1225,The Roommate,16000000,52545707,36545707,2.2841066875,True,2,"['Drama', 'Thriller']",4.9
1547,The Rover,8500000,3180252,-5319748,-0.625852705882353,False,7,"['Action', 'Crime', 'Drama']",6.4
605,The Rum Diary,45000000,21544732,-23455268,-0.5212281777777777,False,10,"['Comedy', 'Drama']",6.2
1519,The Runaways,9500000,5278632,-4221368,-0.4443545263157895,False,3,['Adventure'],9.2
327,The Saint,90000000,169400000,79400000,0.8822222222222222,False,7,['Drama'],6.4
1535,The Sapphires,9000000,20395040,11395040,1.2661155555555557,False,3,"['Biography', 'Comedy', 'Drama']",7.0
1425,The Second Best Exotic Marigold Hotel,10000000,90384306,80384306,8.0384306,True,3,"['Comedy', 'Drama']",6.6
377,The Secret Life of Pets,75000000,886750534,811750534,10.823340453333333,True,7,"['Adventure', 'Animation', 'Comedy']",6.5
315,The Secret Life of Walter Mitty,91000000,187861183,96861183,1.0644086043956045,False,12,"['Adventure', 'Comedy', 'Drama']",7.3
2031,The Sessions,1000000,11495204,10495204,10.495204,True,10,"['Biography', 'Comedy', 'Drama']",7.2
1320,The Shallows,13000000,118763442,105763442,8.135649384615384,True,6,"['Drama', 'Horror', 'Thriller']",6.3
1151,The Shape of Water,19500000,195790794,176290794,9.040553538461538,True,12,"['Adventure', 'Drama', 'Fantasy']",7.3
1771,The Signal,4000000,2665322,-1334678,-0.3336695,False,6,"['Drama', 'Mystery', 'Sci-Fi']",6.1
2055,The Sisterhood of Night,1000000,6870,-993130,-0.99313,False,4,"['Drama', 'Mystery', 'Thriller']",6.2
701,The Sisters Brothers,38000000,13143056,-24856944,-0.6541301052631578,False,9,"['Adventure', 'Comedy', 'Crime']",7.0
959,The Sitter,25000000,38749404,13749404,0.54997616,False,12,['Horror'],4.0
2033,The Skeleton Twins,1000000,5797192,4797192,4.797192,True,9,"['Comedy', 'Drama', 'Romance']",6.8
2018,The Sleepwalker,1100000,2636,-1097364,-0.9976036363636364,False,1,['Drama'],4.9
255,The Smurfs,110000000,563749323,453749323,4.124993845454545,True,7,"['Adventure', 'Animation', 'Comedy']",5.5
262,The Smurfs 2,110000000,348547523,238547523,2.1686138454545456,True,7,"['Adventure', 'Animation', 'Comedy']",5.4
770,The Snowman,35000000,43226146,8226146,0.23503274285714285,False,10,"['Crime', 'Drama', 'Mystery']",5.1
636,The Social Network,40000000,224922135,184922135,4.623053375,True,10,"['Biography', 'Drama']",7.7
1287,The Son of No One,15000000,1148578,-13851422,-0.9234281333333333,False,11,"['Action', 'Crime', 'Drama']",5.1
126,The Sorcerer's Apprentice,160000000,217986320,57986320,0.3624145,False,7,"['Action', 'Adventure', 'Family']",6.1
869,The Space Between Us,30000000,16481405,-13518595,-0.45061983333333333,False,2,"['Adventure', 'Drama', 'Romance']",6.4
1875,The Spectacular Now,2500000,6916951,4416951,1.7667804,False,9,"['Comedy', 'Drama', 'Romance']",7.1
395,The SpongeBob Movie: Sponge Out of Water,74000000,311013181,237013181,3.2028808243243243,True,2,"['Adventure', 'Animation', 'Comedy']",6.0
909,The Spy Next Door,28000000,46752858,18752858,0.6697449285714285,False,1,"['Action', 'Comedy', 'Family']",5.5
1959,The Square,1900000,740932,-1159068,-0.6100357894736842,False,10,"['Documentary', 'Drama', 'History']",8.1
1086,The Star,20000000,62758010,42758010,2.1379005,True,11,"['Adventure', 'Animation', 'Comedy']",6.1
1690,The Strangers: Prey at Night,5000000,29960051,24960051,4.9920102,True,3,['Horror'],5.2
1749,The Sweeney,4500000,8000366,3500366,0.7778591111111111,False,3,"['Action', 'Crime', 'Drama']",6.1
1158,The Switch,19000000,49858465,30858465,1.6241297368421053,False,8,"['Comedy', 'Drama', 'Romance']",6.1
1142,The Tempest,20000000,277943,-19722057,-0.98610285,False,12,['Drama'],7.8
1255,The Theory of Everything,15000000,123327692,108327692,7.221846133333333,True,11,"['Biography', 'Drama', 'Romance']",7.7
700,The Thing,38000000,27573078,-10426922,-0.2743926842105263,False,10,"['Horror', 'Mystery', 'Sci-Fi']",6.2
331,The Three Musketeers,90000000,139877913,49877913,0.5541990333333333,False,10,['Adventure'],3.7
828,The Three Stooges,30000000,54052249,24052249,0.8017416333333334,False,4,"['Comedy', 'Family']",5.1
1984,The To Do List,1500000,4128828,2628828,1.752552,False,7,"['Comedy', 'Romance']",5.8
282,The Tourist,100000000,278731369,178731369,1.78731369,False,12,"['Action', 'Adventure', 'Thriller']",6.0
709,The Town,37000000,152566881,115566881,3.1234292162162163,True,9,"['Crime', 'Drama', 'Thriller']",7.6
1044,The Transporter Refueled,22000000,69698495,47698495,2.168113409090909,True,9,"['Action', 'Adventure', 'Crime']",5.2
764,The Tree of Life,35000000,61721826,26721826,0.7634807428571428,False,5,"['Drama', 'Fantasy']",6.8
418,The Twilight Saga: Eclipse,68000000,706102828,638102828,9.383865117647058,True,6,"['Adventure', 'Drama', 'Fantasy']",5.0
702,The Upside,37500000,119024536,81524536,2.1739876266666665,True,1,"['Comedy', 'Drama']",6.7
2021,The Vatican Exorcisms,1100000,0,-1100000,-1.0,False,5,['Horror'],2.5
1337,The Vatican Tapes,13000000,14929184,1929184,0.14839876923076922,False,7,"['Horror', 'Thriller']",5.0
1787,The Veil,4000000,0,-4000000,-1.0,False,1,"['Action', 'Adventure', 'Sci-Fi']",3.5
1924,The Virginity Hit,2000000,636706,-1363294,-0.681647,False,9,['Comedy'],4.6
1675,The Visit,5000000,98677816,93677816,18.7355632,True,5,"['Comedy', 'Drama', 'Romance']",8.3
812,The Vow,30000000,197618160,167618160,5.587272,True,2,"['Drama', 'Romance']",6.8
768,The Walk,35000000,61492104,26492104,0.7569172571428572,False,10,"['Crime', 'Thriller']",6.8
1951,The Walking Deceased,2000000,0,-2000000,-1.0,False,3,"['Comedy', 'Horror']",3.5
1842,The Wall,3000000,4495262,1495262,0.4984206666666667,False,5,['Documentary'],9.2
627,The Warrior's Way,42000000,8514325,-33485675,-0.7972779761904762,False,12,"['Action', 'Fantasy', 'Western']",6.3
511,The Watch,55000000,67130045,12130045,0.22054627272727273,False,7,"['Action', 'Comedy', 'Horror']",5.7
786,The Watcher,33000000,47267829,14267829,0.4323584545454545,False,10,['Drama'],7.8
1034,The Water Diviner,22500000,31054727,8554727,0.3802100888888889,False,4,"['Drama', 'History', 'War']",7.1
1691,The Way Way Back,5000000,26853810,21853810,4.370762,True,7,"['Comedy', 'Drama']",7.4
1021,The Wedding Ringer,23000000,80171596,57171596,2.4857215652173914,True,1,['Comedy'],6.7
2016,The Wicked Within,1200000,0,-1200000,-1.0,False,10,['Horror'],4.5
1795,The Witch,3500000,40454520,36954520,10.558434285714286,True,2,"['Horror', 'Mystery']",6.8
277,The Wolf of Wall Street,100000000,389870414,289870414,2.89870414,True,12,"['Biography', 'Crime', 'Drama']",8.2
151,The Wolfman,150000000,142634358,-7365642,-0.04910428,False,2,"['Drama', 'Fantasy', 'Horror']",5.8
248,The Wolverine,115000000,416456852,301456852,2.6213639304347827,True,7,"['Action', 'Adventure', 'Sci-Fi']",6.7
1244,The Woman in Black,15000000,128955898,113955898,7.597059866666667,True,2,"['Drama', 'Fantasy', 'Horror']",6.4
2171,The Word,200000,3648,-196352,-0.98176,False,4,['Drama'],6.7
1624,The Words,6000000,16369708,10369708,1.7282846666666667,False,9,"['Drama', 'Mystery', 'Romance']",7.1
1102,The World's End,20000000,47508505,27508505,1.37542525,False,8,"['Action', 'Comedy', 'Sci-Fi']",7.0
1221,The Young Messiah,16800000,7313697,-9486303,-0.5646608928571428,False,3,"['Drama', 'Fantasy']",5.6
788,The Young and Prodigious T.S. Spivet,33000000,357687,-32642313,-0.989161,False,10,"['Action', 'Adventure', 'Comedy']",7.1
719,There Be Dragons,36000000,4020990,-31979010,-0.8883058333333334,False,5,"['Biography', 'Drama', 'War']",5.8
1857,They Came Together,3000000,82780,-2917220,-0.9724066666666666,False,6,"['Comedy', 'Romance']",5.5
2098,They Will Have to Kill Us First,600000,7943,-592057,-0.9867616666666666,False,8,['Documentary'],7.3
1349,Think Like a Man,12000000,113373764,101373764,8.447813666666667,True,4,"['Comedy', 'Romance']",6.6
1010,Think Like a Man Too,24000000,70027933,46027933,1.9178305416666668,False,6,"['Comedy', 'Romance']",5.8
2212,This Is Martin Bonner,42000,0,-42000,-1.0,False,6,['Drama'],6.6
436,This Means War,65000000,156974557,91974557,1.4149931846153847,False,2,"['Action', 'Comedy', 'Romance']",6.3
143,Thor,150000000,449326618,299326618,1.9955107866666666,False,5,"['Action', 'Adventure', 'Fantasy']",7.0
73,Thor: Ragnarok,180000000,846980024,666980024,3.7054445777777776,True,11,"['Action', 'Adventure', 'Comedy']",7.9
141,Thor: The Dark World,150000000,644602516,494602516,3.297350106666667,True,11,"['Action', 'Adventure', 'Fantasy']",6.9
1711,Thoroughbreds,5000000,3187302,-1812698,-0.3625396,False,3,"['Comedy', 'Crime', 'Drama']",6.7
1354,"Three Billboards Outside Ebbing, Missouri",12000000,160191915,148191915,12.34932625,True,11,"['Crime', 'Drama']",8.2
783,Thunder and the House of Magic,34000000,62582520,28582520,0.8406623529411764,False,7,"['Adventure', 'Animation', 'Comedy']",6.3
2195,Tiger Orange,100000,0,-100000,-1.0,False,7,['Drama'],6.6
1851,Tim and Eric's Billion Dollar Movie,3000000,223652,-2776348,-0.9254493333333333,False,3,['Comedy'],5.4
1808,Time to Choose,3500000,29233,-3470767,-0.9916477142857143,False,9,['Documentary'],7.5
1061,Tinker Tailor Soldier Spy,21000000,81452811,60452811,2.8787052857142856,True,12,"['Drama', 'Mystery', 'Thriller']",7.1
2204,Tiny Furniture,50000,424149,374149,7.48298,True,11,"['Comedy', 'Drama', 'Romance']",6.2
1054,To Rome with Love,21500000,74326015,52826015,2.457023953488372,True,6,"['Comedy', 'Music', 'Romance']",6.3
328,Tomb Raider,90000000,273477501,183477501,2.0386389,True,3,"['Action', 'Adventure', 'Fantasy']",6.3
102,Tomorrowland,170000000,206627518,36627518,0.2154559882352941,False,5,['Documentary'],6.3
579,Tooth Fairy,48000000,112610386,64610386,1.3460497083333334,False,1,['Horror'],2.6
1365,Top Five,12000000,26001741,14001741,1.16681175,False,12,"['Comedy', 'Romance']",6.4
2180,Top Spin,150000,5858,-144142,-0.9609466666666666,False,11,['Documentary'],6.9
230,Total Recall,125000000,211856088,86856088,0.694848704,False,8,"['Action', 'Adventure', 'Mystery']",6.3
341,Tower Heist,85000000,150422946,65422946,0.7696817176470588,False,11,"['Action', 'Comedy', 'Crime']",6.2
41,Toy Story 3,200000000,1068879522,868879522,4.34439761,True,6,"['Adventure', 'Animation', 'Comedy']",8.3
1620,Tracker,6500000,3149,-6496851,-0.9995155384615385,False,9,"['Action', 'Adventure', 'Drama']",6.5
726,Trainwreck,35000000,141123897,106123897,3.0321113428571427,True,7,"['Comedy', 'Drama', 'Romance']",6.2
1231,Trance,16000000,22594052,6594052,0.41212825,False,4,['Horror'],4.6
293,Transcendence,100000000,103039258,3039258,0.03039258,False,4,['Drama'],6.1
28,Transformers: Age of Extinction,210000000,1104039076,894039076,4.2573289333333335,True,6,"['Action', 'Adventure', 'Sci-Fi']",5.7
55,Transformers: Dark of the Moon,195000000,1123790543,928790543,4.763028425641026,True,6,"['Action', 'Adventure', 'Sci-Fi']",6.2
25,Transformers: The Last Knight,217000000,602893340,385893340,1.7783103225806451,False,6,"['Action', 'Adventure', 'Sci-Fi']",5.2
873,Trapped,30000000,6916869,-23083131,-0.7694377,False,1,"['Drama', 'Mystery', 'Thriller']",8.4
1387,Trash,12000000,6553186,-5446814,-0.4539011666666667,False,10,['Action'],7.2
2095,Treachery,625000,0,-625000,-1.0,False,12,"['Drama', 'Thriller']",3.7
1742,Treading Water,4700000,0,-4700000,-1.0,False,3,"['Comedy', 'Drama']",6.2
775,Trespass,35000000,786532,-34213468,-0.9775276571428572,False,10,"['Crime', 'Drama', 'Thriller']",5.3
1390,Triangle,12000000,1594955,-10405045,-0.8670870833333333,False,2,['Drama'],6.9
1118,Triple 9,20000000,25943792,5943792,0.2971896,False,2,"['Crime', 'Thriller']",6.3
225,Trolls,125000000,344150134,219150134,1.753201072,False,11,"['Adventure', 'Animation', 'Comedy']",6.5
478,Trouble with the Curve,60000000,47818913,-12181087,-0.20301811666666666,False,9,"['Drama', 'Sport']",6.8
723,True Grit,35000000,252276928,217276928,6.207912228571429,True,12,"['Adventure', 'Drama', 'Western']",7.6
1779,Trust,4000000,120016,-3879984,-0.969996,False,4,['Drama'],7.3
1793,Truth or Dare,3500000,95127344,91627344,26.179241142857144,True,10,"['Comedy', 'Romance']",5.0
1000,Tulip Fever,25000000,6792768,-18207232,-0.72828928,False,8,"['Drama', 'History', 'Romance']",6.2
172,Turbo,135000000,286896578,151896578,1.125159837037037,False,7,"['Adventure', 'Animation', 'Comedy']",6.4
516,Turbulence,55000000,11532774,-43467226,-0.7903132,False,12,['Drama'],6.8
1840,Tusk,3000000,1887554,-1112446,-0.37081533333333333,False,9,"['Comedy', 'Drama', 'Horror']",5.3
1607,Twixt,7000000,1268346,-5731654,-0.8188077142857143,False,8,"['Comedy', 'Fantasy', 'Horror']",4.8
1977,Two Night Stand,1600000,868081,-731919,-0.457449375,False,9,"['Comedy', 'Romance']",6.4
689,USS Indianapolis: Men of Courage,40000000,1663785,-38336215,-0.958405375,False,1,"['Action', 'Drama', 'History']",5.2
431,Unbroken,65000000,163527824,98527824,1.5158126769230769,False,12,"['Biography', 'Drama', 'Sport']",7.2
1175,Uncle Drew,18000000,46527161,28527161,1.5848422777777778,False,6,"['Comedy', 'Sport']",5.7
1113,Under the Rainbow,20000000,18826490,-1173510,-0.0586755,False,6,['Horror'],6.2
1313,Under the Skin,13300000,7229933,-6070067,-0.45639601503759397,False,4,"['Drama', 'Horror', 'Sci-Fi']",6.3
1881,Underdogs,2500000,1392649,-1107351,-0.4429404,False,4,"['Drama', 'Family', 'Sport']",5.8
749,Underworld: Blood Wars,35000000,81209222,46209222,1.3202634857142856,False,1,"['Action', 'Adventure', 'Fantasy']",5.8
767,Unfinished Business,35000000,13214051,-21785949,-0.6224556857142857,False,3,['Horror'],7.2
1194,Unforgettable,18000000,2483790,-15516210,-0.8620116666666666,False,4,['Documentary'],5.9
2023,Unfriended,1000000,64364198,63364198,63.364198,True,4,"['Horror', 'Mystery', 'Thriller']",5.6
2028,Unfriended: Dark Web,1000000,16434588,15434588,15.434588,True,7,"['Crime', 'Horror', 'Mystery']",5.9
891,Unhinged,29000000,0,-29000000,-1.0,False,8,['Horror'],4.2
881,United Passions,30000000,168832,-29831168,-0.9943722666666667,False,6,"['Drama', 'History', 'Sport']",2.1
650,Unknown,40000000,136123083,96123083,2.403077075,True,2,['Drama'],6.9
1865,Unnatural,3000000,0,-3000000,-1.0,False,10,"['Action', 'Horror', 'Sci-Fi']",4.0
1982,Unsane,1500000,14244931,12744931,8.496620666666667,True,3,"['Drama', 'Horror', 'Mystery']",6.4
306,Unstoppable,95000000,165720921,70720921,0.7444307473684211,False,11,['Documentary'],8.1
1988,Unsullied,1500000,510957,-989043,-0.659362,False,8,"['Action', 'Horror', 'Thriller']",4.3
1827,Upgrade,3000000,16553285,13553285,4.517761666666667,True,6,['Drama'],8.8
571,Upside Down,50000000,26387039,-23612961,-0.47225922,False,3,['Drama'],7.7
806,Vacation,31000000,102306500,71306500,2.300209677419355,True,4,"['Adventure', 'Comedy']",6.1
522,Valentine's Day,52000000,217569328,165569328,3.1840255384615386,True,2,"['Comedy', 'Romance']",5.7
80,Valerian and the City of a Thousand Planets,180000000,215098356,35098356,0.19499086666666668,False,7,"['Action', 'Adventure', 'Fantasy']",6.5
1110,Vampires,20000000,20268825,268825,0.01344125,False,7,"['Comedy', 'Fantasy', 'Horror']",6.2
1091,Vampires Suck,20000000,81424988,61424988,3.0712494,True,8,['Comedy'],3.4
1235,Vamps,16000000,94812,-15905188,-0.99407425,False,11,"['Comedy', 'Horror', 'Thriller']",4.5
245,Venom,116000000,853628605,737628605,6.358867284482758,True,10,['Thriller'],3.0
1631,Veronica Mars,6000000,3485383,-2514617,-0.4191028333333333,False,3,"['Crime', 'Drama', 'Mystery']",6.8
2084,Vessel,800000,0,-800000,-1.0,False,10,['Sci-Fi'],6.4
470,Vice,60000000,70883171,10883171,0.18138618333333334,False,1,"['Action', 'Adventure', 'Sci-Fi']",4.2
686,Victor Frankenstein,40000000,31124367,-8875633,-0.221890825,False,11,"['Drama', 'Horror', 'Sci-Fi']",6.0
2091,Walter,700000,0,-700000,-1.0,False,3,['Comedy'],6.4
793,Wanderlust,32500000,24159934,-8340066,-0.2566174153846154,False,2,"['Comedy', 'Romance']",5.6
964,War,25000000,40686409,15686409,0.62745636,False,2,['Drama'],6.8
552,War Dogs,50000000,86234503,36234503,0.72469006,False,8,"['Comedy', 'Crime', 'Drama']",7.1
398,War Horse,70000000,156815529,86815529,1.2402218428571428,False,12,['Drama'],8.6
1822,War Room,3000000,73975239,70975239,23.658413,True,8,['Drama'],6.5
132,War for the Planet of the Apes,152000000,489592267,337592267,2.2210017565789473,True,7,"['Action', 'Adventure', 'Drama']",7.5
176,War of the Worlds,132000000,606836535,474836535,3.5972464772727273,True,10,['Sci-Fi'],5.8
127,Warcraft,160000000,425522281,265522281,1.65951425625,False,6,"['Action', 'Adventure', 'Fantasy']",6.9
815,Warm Bodies,30000000,115121608,85121608,2.8373869333333332,True,2,"['Comedy', 'Horror', 'Romance']",6.9
987,Warrior,25000000,24215385,-784615,-0.0313846,False,9,"['Drama', 'Sport']",8.2
2096,Water & Power,600000,42557,-557443,-0.9290716666666666,False,5,"['Crime', 'Drama']",6.2
695,Water for Elephants,38000000,116809717,78809717,2.0739399210526317,True,4,"['Drama', 'Romance']",6.9
1914,We Are Your Friends,2000000,10153415,8153415,4.0767075,True,8,"['Drama', 'Music', 'Romance']",6.2
542,We Bought a Zoo,50000000,118729073,68729073,1.37458146,False,12,"['Comedy', 'Drama', 'Family']",7.1
1600,We Need to Talk About Kevin,7000000,10765283,3765283,0.5378975714285714,False,12,"['Drama', 'Mystery', 'Thriller']",7.5
706,We're the Millers,37000000,267816276,230816276,6.23827772972973,True,8,"['Comedy', 'Crime']",7.0
2174,Weekend,190000,1577585,1387585,7.303078947368421,True,9,['Horror'],3.8
606,Welcome to Marwen,45000000,12874922,-32125078,-0.7138906222222222,False,12,"['Biography', 'Comedy', 'Drama']",6.1
1497,Welcome to the Rileys,10000000,355919,-9644081,-0.9644081,False,10,['Drama'],7.0
428,What Women Want,65000000,374105123,309105123,4.755463430769231,True,2,"['Comedy', 'Romance', 'Sci-Fi']",5.6
703,What to Expect When You're Expecting,37500000,88473016,50973016,1.3592804266666667,False,5,"['Comedy', 'Drama', 'Romance']",5.7
1115,What's Your Number?,20000000,30163785,10163785,0.50818925,False,9,"['Comedy', 'Romance']",6.1
1428,When the Bough Breaks,10000000,30768449,20768449,2.0768449,True,9,['nan'],6.1
1258,When the Game Stands Tall,15000000,30138912,15138912,1.0092608,False,8,"['Drama', 'Family', 'Sport']",6.7
1464,While We're Young,10000000,17503828,7503828,0.7503828,False,4,"['Comedy', 'Drama', 'Mystery']",6.3
1813,Whiplash,3300000,38969037,35669037,10.80879909090909,True,1,"['Drama', 'Music']",8.5
756,Whiskey Tango Foxtrot,35000000,25350747,-9649253,-0.27569294285714285,False,3,"['Biography', 'Comedy', 'Drama']",6.6
854,White Boy Rick,30000000,25947983,-4052017,-0.13506723333333334,False,9,"['Crime', 'Drama']",6.4
1295,White Fang,14000000,34729091,20729091,1.4806493571428572,False,1,"['Adventure', 'Animation']",7.0
150,White House Down,150000000,205440387,55440387,0.36960258,False,6,"['Action', 'Drama', 'Thriller']",6.4
1075,Why Did I Get Married Too?,20000000,60831067,40831067,2.04155335,True,4,"['Comedy', 'Drama', 'Romance']",4.6
693,Why Him?,38000000,117425156,79425156,2.0901356842105265,True,12,['Comedy'],6.2
659,Widows,40000000,73866088,33866088,0.8466522,False,11,"['Comedy', 'Drama']",6.3
1254,Wild,15000000,52460543,37460543,2.4973695333333334,True,1,"['Drama', 'Romance']",4.9
879,Wild Card,30000000,4315789,-25684211,-0.8561403666666667,False,1,"['Action', 'Crime', 'Drama']",5.6
1573,Wild Target,8000000,5314194,-2685806,-0.33572575,False,10,"['Action', 'Comedy', 'Crime']",6.8
1663,Wilson,5200000,2000000,-3200000,-0.6153846153846154,False,3,['Documentary'],7.1
1797,Winchester,3500000,44378040,40878040,11.67944,True,2,"['Biography', 'Drama', 'Fantasy']",5.4
1953,Wind Walkers,2000000,0,-2000000,-1.0,False,10,"['Action', 'Horror', 'Thriller']",3.8
2081,Windsor Drive,850000,3256,-846744,-0.9961694117647059,False,6,"['Mystery', 'Thriller']",3.2
1944,Wings,2000000,0,-2000000,-1.0,False,10,"['Adventure', 'Animation', 'Comedy']",3.2
1286,Winnie Mandela,15000000,61847,-14938153,-0.9958768666666666,False,9,"['Biography', 'Drama', 'History']",6.0
853,Winnie the Pooh,30000000,50145607,20145607,0.6715202333333333,False,7,"['Adventure', 'Animation', 'Comedy']",7.2
1909,Winter's Bone,2000000,16131551,14131551,7.0657755,True,6,"['Drama', 'Mystery']",7.2
1630,Wish I Was Here,6000000,6591365,591365,0.09856083333333333,False,1,"['Comedy', 'Drama']",6.7
1372,Wish Upon,12000000,23477345,11477345,0.9564454166666667,False,7,"['Drama', 'Fantasy', 'Horror']",5.0
1741,Without Men,4700000,0,-4700000,-1.0,False,6,['Comedy'],3.3
401,Wolf,70000000,131011757,61011757,0.8715965285714286,False,3,['Drama'],4.1
1199,Wolves,18000000,94953,-17905047,-0.9947248333333333,False,10,"['Drama', 'Sport']",5.6
1399,Woman in Gold,11000000,58586407,47586407,4.326037,True,4,"['Biography', 'Drama', 'History']",7.3
1340,Womb,13000000,0,-13000000,-1.0,False,7,"['Drama', 'Romance', 'Sci-Fi']",6.4
1164,Won't Back Down,19000000,5745503,-13254497,-0.6976051052631579,False,6,['Sport'],7.9
1068,Wonder,20000000,304604712,284604712,14.2302356,True,11,"['Drama', 'Family']",8.0
134,Wonder Woman,150000000,821133378,671133378,4.47422252,True,6,"['Documentary', 'Drama', 'Sport']",6.9
1656,Wonderland,5500000,1060512,-4439488,-0.8071796363636363,False,1,"['Comedy', 'Drama']",6.1
1330,Woodlawn,13000000,14403703,1403703,0.10797715384615385,False,10,"['Drama', 'Sport']",6.5
61,World War Z,190000000,531514650,341514650,1.7974455263157896,False,6,"['Action', 'Adventure', 'Horror']",7.0
148,Wrath of the Titans,150000000,305270083,155270083,1.0351338866666666,False,3,"['Action', 'Adventure', 'Fantasy']",5.7
110,Wreck-It Ralph,165000000,496511521,331511521,2.0091607333333332,True,11,"['Adventure', 'Animation', 'Comedy']",7.7
1574,Wuthering Heights,8000000,2721534,-5278466,-0.65980825,False,4,"['Horror', 'Romance']",6.7
82,X-Men: Apocalypse,178000000,542537546,364537546,2.047963741573034,True,5,"['Action', 'Adventure', 'Sci-Fi']",7.0
50,X-Men: Days of Future Past,200000000,747862775,547862775,2.739313875,True,5,"['Action', 'Adventure', 'Sci-Fi']",8.0
125,X-Men: First Class,160000000,355408305,195408305,1.22130190625,False,6,"['Action', 'Adventure', 'Sci-Fi']",7.7
1732,Yoga Hosers,5000000,22958,-4977042,-0.9954084,False,9,"['Action', 'Comedy', 'Fantasy']",4.3
358,Yogi Bear,80000000,204774690,124774690,1.559683625,False,12,"['Adventure', 'Animation', 'Comedy']",4.6
1103,You Again,20000000,32838945,12838945,0.64194725,False,9,"['Comedy', 'Family', 'Romance']",5.8
1276,You Will Meet a Tall Dark Stranger,15000000,34247816,19247816,1.2831877333333332,False,5,"['Comedy', 'Drama', 'Romance']",6.3
2024,You're Next,1000000,26887177,25887177,25.887177,True,8,"['Action', 'Comedy', 'Horror']",6.6
1369,Young Adult,12000000,22750356,10750356,0.895863,False,12,"['Comedy', 'Drama']",6.3
561,Your Highness,50000000,26121638,-23878362,-0.47756724,False,1,"['Adventure', 'Comedy', 'Fantasy']",5.5
2185,Your Sister's Sister,120000,3090593,2970593,24.754941666666667,True,6,"['Comedy', 'Drama']",6.7
1334,Youth,13000000,24001573,11001573,0.8462748461538462,False,10,['Drama'],7.3
1145,Zambezia,20000000,34454336,14454336,0.7227168,False,7,"['Adventure', 'Animation', 'Comedy']",5.8
521,Zero Dark Thirty,52500000,134612435,82112435,1.564046380952381,False,12,"['Drama', 'Thriller']",7.4
1751,Zipper,4500000,0,-4500000,-1.0,False,8,"['Drama', 'Thriller']",5.8
362,Zookeeper,80000000,170805525,90805525,1.1350690625,False,7,"['Comedy', 'Family', 'Romance']",5.2
558,Zoolander 2,50000000,55348693,5348693,0.10697386,False,2,['Comedy'],4.7
765,Zoom,35000000,12506188,-22493812,-0.6426803428571428,False,9,['Horror'],5.4
137,Zootopia,150000000,1019429616,869429616,5.79619744,True,3,"['Adventure', 'Animation', 'Comedy']",8.0
344,xXx: Return of Xander Cage,85000000,345033359,260033359,3.059215988235294,True,1,"['Action', 'Adventure', 'Thriller']",5.2
